Flugzeug/ -e	the airplane	das
Gefahr/ -en	the danger, risk	die
Bank/ -en	the bank	die
Professor/ -en	the professor	der
Partner/ -s	the partner ('Gesellschafter' or ...)	der
Opfer/ -	the sacrifice, victim, casualty	das
See/ -n	the lake	der
See/ -n	the sea ('Meer' or ...)	die
Meer/ -e	the sea ('See' or ...)	das
Hochzeit/ -en	the wedding	die
Geburtstag/ -e	the birthday	der
Hut/ -"e	the hat	der
Liste/ -n	the list	die
Karte/ -n	the card	die
Gesellschaft/ -en	the society	die
Kirche/ -n	the church	die
Kontrolle/ -n	the inspection, monitoring, examination, control (K_)	die
Zeichen/ -	the sign	das
Foto/ -s	the photo	das
Aussehen	the physical appearance, looks, look	das
Hoffnung/ -en	the hope	die
Ball/ -"e	the ball (as in a dance event)	der
Wein/ -e	the wine	der
Szene/ -n	the scene	die
Vergnügen/ -	the pleasure, the delight	das
Tante/ -n	the aunt	die
Fuß/ -"e	the foot	der
Mut	the courage (no plural)	der
Geheimnis/ -se	the secret	das
Bein/ -e	the leg	das
Gruppe/ -n	the group	die
Amerikaner/ -	the American person	der
Hals/ -"e	the neck	der
Besuch/ -e	the visit	der
Entscheidung/ -en	the decision	die
Wind/ -e	the wind	der
Polizist/ -en/ -en	the male police officer	der
Sekunde/ -n	the second	die
Dorf/ -"er	the village	das
Glas/ -"er	the glass	das
Firma/ die Firmen	the company, the enterprise	die
Lust	the desire (to do sth.)/ the passion (no plural)	die
Blick/ -e	the glimpse, sight, glance, look, view	der
Meter/ -	the meter	der
Loch/ -"er	the hole	das
Freude/ -n	the joy	die
Insel/ -n	the island	die
Fleisch	the meat (no plural)	das
Schmerz/ -en	the pain	der
Zeitung/ -en	the newspaper	die
Gebäude/ -	the building	das
Messer/ -	the knife	das
Kontakt/ -e	the contact	der
Rat/ -"e	the advice, counsel (Ratschlag, Beratung, or ...)	der
Aufmerksamkeit/ -en	the attention, interest, attentiveness	die
Lage/ -n	1. the location, position. 2. the situation	die
Schicksal/ -e	the fate	das
Punkt/ -e	the dot, the period	der
Witz/ -e	the joke	der
mal	this time	die
Unfall/ -"e	the accident	der
Hunger	the hunger (no plural)	der
Kamera/ -s	the camera ('K_')	die
Taxi/ -s	the taxi	das
Tee	the tea (no plural)	der
Haar/ -e	the hair	das
Bus/ -se	the bus (Autobus, or ...)	der
Richter/ -	the judge	der
Lied/ -er	the song	das
Computer/ -	the computer	der
Verstecken	the hide and seek	das
Königin/ -nen	the queen	die
Bericht/ -e	the report	der
Fisch/ -e	the fish	der
Vergangenheit/ -en	the past	die
Agent/ -en/ -en	the agent	der
Position/ -en	the position ('p_')	die
Küche/ -n	the kitchen	die
Ring/ -e	the ring	der
Gegend/ -en	the area, neighborhood, region	die
Verbindung/ -en	the connection, the combination, the link	die
Kleid/ -er	the dress (generally worn by women)	das
Ecke/ -n	the corner	die
Radio/ -s	the radio	das
Eis	the ice (no plural)	das
Flug/ -"e	the flight	der
Maschine/ -n	the machine	die
Sommer/ -	the summer	der
Respekt	the respect ('Hinsicht' or ...)	der
Adresse/ -n	the address	die
Fahrt/ -en	the journey, trip ('F_')	die
Aufgabe/ -n	the task, assignment, purpose, duty, surrender, job	die
Beziehung/ -en	the relationship	die
Wald/ -"er	the forest	der
Park/ -s	the park	der
Hälfte/ -n	the half	die
Koffer/ -	the suitcase	der
Pistole/ -n	the gun, pistol	die
Brücke/ -n	the bridge	die
Knast/ -"e	the jail, the slammer (colloquial)	der
Quatsch	the nonsense (no plural) ('Q_')	der
Unterschied/ -e	the difference	der
Tor/ -e	the gate	das
Glückwunsch/ -"e	the best wishes	der
Soldat/ -en	the soldier	der
Baum/ -"e	the tree	der
System/ -e	the system	das
Club/ -s	the club (..., 'Klub', 'Verein')	der
Lächeln/ -	the smile	das
Abendessen/ -	the supper ('Abendbrot' or ...)	das
Flasche/ -n	the bottle	die
Rauchen	the smoking (no plural)	das
Vogel/ -"	the bird	der
Dach/ -"er	the roof	das
Lehrer/ -	the teacher	der
Katze/ -n	the cat	die
Tier/ -e	the animal	das
Gehirn/ -e	the brain	das
Theater/ -	the theatre	das
Erfolg/ -e	the success	der
Fluss/ -"e	the river	der
City	the city, downtown (no plural)	die
Haufen/ -	the pile	der
Wand/ -"e	the wall (Mauer, or ...)	die
Grad/ -e	the degree (a unit of measure)	der
Natur/ -en	the nature, character, natural world	die
Angriff/ -e	the attack ('Überfall, Anschlag' or ...)	der
Möglichkeit/ -en	the possibility	die
Farbe/ -n	the color	die
Spur/ -en	the track/ the lane (in traffic)/ the trace (of sth.)	die
Frühstück/ -e	the breakfast	das
Runde/ -n	the lap (in sports)	die
Wochenende/ -n	the weekend	das
Untertitel/ -	the subtitle, subheading, subtitles, caption	der
Mond/ -e	the moon	der
Hose/ -n	the pants	die
Rock/ -"e	the skirt, rock (stone), rock music	der
Rock	the rock music (no plural)	der
Pfund/ -e	the pound (weight)	das
Braut/ -"e	the bride	die
Reihe/ -n	the row	die
Sprache/ -n	the language	die
Gespräch/ -e	the conversation (not 'U..', 'K..')	das
Flughafen/ -"	the airport	der
Wunsch/ -"e	the wish	der
Stein/ -e	the stone	der
Pause/ -n	the break, the intermission (Unterbrechung, or ...)	die
Nachmittag/ -e	the afternoon	der
Auftrag/ -"e	the order (commerce)/ the assignment	der
Regen/ -	the rain (no plural)	der
Lüge/ -n	the lie	die
Post/ -en	the mail, post (BR), post office	die
Schaden/ -"	the damage	der
Tanz/ -"e	the dance	der
Urlaub/ -e	the vacation (for working people)	der
Gelegenheit/ -en	the opportunity	die
Folge/ -n	the consequence ('Konsequenz' or ...)	die
Verantwortung/ -en	the responsibility (not '...keit')	die
Thema/ die Themen	the topic	das
Keller/ -	the cellar, the basement	der
Erfahrung/ -en	the experience (not 'erlebnis')	die
Schloss/ -"er	1. the lock. 2. the castle	das
Angebot/ -e	the offer	das
Anzug/ -"e	the suit (man's suit)	der
Strand/ -"e	the beach	der
Grab/ -"er	the grave	das
Restaurant/ -s	the restaurant ('R_')	das
Schatten/ -	the shade	der
Gang/ -"e	course, gear (transmission), aisle	der
Lager/ -	the warehouse	das
Sieg/ -e	the victory	der
Kugel/ -n	the ball, the scoop	die
Milch	the milk (no plural)	die
Gewalt	the violence (no plural)	die
Schönheit/ -en	the beauty	die
Pflicht/ -en	the duty	die
Kunst/ -"e	the art	die
Kuss/ -"e	the kiss	der
Knie/ -	the knee	das
Priester/ -	the priest	der
Form/ -en	the shape, the form ('Gestalt' or ...)	die
Kurs/ -e	1. the course. 2. the exchange rate	der
Großvater/ -"	the grandfather	der
Fahrer/ -	the male driver	der
Million/ -en	the million	die
Risiko/ die Risiken	the risk (not 'G...')	das
Test/ -s	the test, trial, quiz	der
Grenze/ -n	the border, limit, boundary	die
Bühne/ -n	the (performance) stage	die
Anhänger/ -	trailer (vehicle), follower, supporter	der
Interesse/ -n	the interest (e.g. to have an interest in smth)	das
Kino/ -s	the cinema	das
Einheit/ -en	the unity, the whole	die
Sonntag/ -e	the Sunday	der
Stern/ -e	the star	der
Blödsinn/ -e	the nonsense ('B_')	der
Freitag/ -e	the Friday	der
Zufall/ -"e	Coincidence, accident, fluke, chance occurence	der
Energie/ -n	the energy	die
Oma/ -s	the grandma (colloquial)	die
Großmutter/ -"	the grandmother	die
Dieb/ -e	the male thief	der
Beweis/ -e	the evidence, proof, verification (Nachweis, Beleg, or ...)	der
Garten/ -"	the garden	der
Mantel/ -"	the coat	der
Brot/ -e	the bread, the sandwich	das
Lösung/ -en	the solution	die
Wetter	the weather (no plural)	das
Champagner	the champagne (produced within the Champagne region of France) (no plural)	der
Publikum/ die Publika	the audience	das
Bulle/ -n	the bull	der
Stuhl/ -"e	the chair (no arms)	der
Schutz/ -e	the protection	der
Karriere/ -n	the career ('K_')	die
Norden	the north (no plural)	der
Hintergrund/ -"e	the background	der
Schüler/ -	the pupil (primary or secondary school)	der
Krankheit/ -en	the illness (Erkrankung, or ...)	die
Süden	the south (no plural)	der
Abteilung/ -en	the department (not 'D...')	die
Vorstellung/ -en	the imagination, notion, introduction (first meetings), perception, idea, concept	die
Samstag/ -e	the Saturday	der
Gast/ -"e	the guest	der
Mitte/ -n	the middle	die
Tausend/ -e	the thousand	das
Ohr/ -en	the ear	das
Berg/ -e	the mountain	der
Rose/ -n	the rose	die
Erinnerung/ -en	the memory, reminder	die
Ton/ -"e	the tone, the sound, the note	der
Gebiet/ -e	the area, terrority, region	das
Westen	the west (no plural)	der
Zweifel/ -	the doubt	der
Staat/ -en	the state	der
Direktor/ -en	the director	der
Kuchen/ -	the cake	der
Kohle/ -n	the coal	die
Medizin/ -en	the medicine (not 'Medikament')	die
Video/ -s	the video	das
Beruf/ -e	the profession	der
Hemd/ -en	the shirt	das
Rechnung/ -en	the bill, the invoice, the calculation	die
Termin/ -e	the appointment, the date ('Verabredung' or ...)	der
Spiegel/ -	the mirror	der
Menschheit	the humanity, human race, human kind, mankind (no plural) ('M_')	die
Sturm/ -"e	the storm	der
Motor/ -en	the motor	der
Winter/ -	the Winter	der
Brust/ -"e	the breast, the chest	die
Größe/ -n	the height, the size	die
Zigarette/ -n	the cigarette	die
Handy/ -s	the cell phone (not 'Mobiltelefon')	das
College/ -s	the college, university (not 'Hochschule', 'Universität')	das
Toilette/ -n	the restroom, lavatory	die
Tatsache/ -n	the fact ('T~')	die
Selbstmord/ -e	the suicide	der
Zunge/ -n	the tongue	die
Treppe/ -n	the stair	die
Streit/ -e	the argument ('S_')	der
Bauch/ -"e	the belly, stomach (Magen, or ...)	der
Decke/ -n	1. the blanket. 2. the ceiling	die
Deutsche/ -n/ -n	the German person	der
Montag/ -e	the Monday	der
Inspektor/ -en	the inspector	der
Eisenbahn/ -en	the railway	die
Papier/ -e	the paper, the document	das
Talent/ -e	the talent (not 'B...')	das
Geschmack/ -"e	the taste	der
Labor/ -s	the laboratory	das
Griff/ -e	the grip, (mus.) the fingering	der
Ei/ -er	the egg	das
Osten	the east (no plural)	der
Alkohol	the alcohol (no plural)	der
Erklärung/ -en	the explanation, clarification, declaration	die
Bürgermeister/ -	the mayor	der
Schnee	the snow (no plural)	der
Zahl/ -en	the number ('Z_')	die
Pech/ -e	bad luck, coal-tar pitch	das
Botschaft/ -en	the message, embassy	die
Stoff/ -e	the material ('Material' or ...)	der
Mitternacht/ -"e	the midnight	die
Verfahren/ -	the procedure, method, process, lawsuit	das
Sendung/ -en	the consignment, program (TV), broadcast	die
Heimat/ -en	the home country, the home town	die
Linie/ -n	the line (Zeile, Leitung, Warteschlange, or ...)	die
Scheck/ -s	the check (to pay bills)	der
Jacke/ -n	the jacket	die
Kleidung/ -en	the clothing	die
Absicht/ -en	the purpose, intention, aim, intent ('A'_)	die
Aussage/ -n	the statement, assertion, testimony ('Au_')	die
Feld/ -er	the field	das
Mühe/ -n	the effort, toil, hassle, trouble ('Anstrengung' or ...)	die
Prozent/ -e	the percent	das
Kuh/ -"e	the cow	die
Spieler/ -	the player	der
Fernseher/ -	the television set	der
Erlaubnis/ -se	the permission	die
Bedeutung/ -en	the meaning, the sense (Sinn, or ...)	die
Hütte/ -n	the hut	die
Brille/ -n	the eyeglasses	die
Eindruck/ -"e	the impression	der
Not/ -"e	the need, the distress	die
Stil/ -e	the style	der
Schlafzimmer/ -	the bedroom	das
Gras/ -"er	the grass	das
Strom/ -"e	the electricity current	der
Titel/ -	the title	der
Geburt/ -en	the birth	die
Universum/ die Universen	the universe (U-)	das
Politik	the politics (no plural)	die
Müll	The garbage, trash, rubbish, refuse (not 'A..')	der
Staub	the dust (no plural)	der
Narr/ -en/ -en	the fool, idiot, dummy, clown ('N_')	der
Vorschlag/ -"e	the suggestion	der
Klo/ -s	the toilet, bathroom, restroom, loo (German slang for "Toilette")	das
Werk/ -e	the work (of art, etc.)	das
Hof/ -"e	courtyard	der
Opa/ -s	the grandpa	der
Künstler/ -	the male artist	der
Kaiser/ -	the emperor	der
Kauf/ -"e	the purchase	der
Projekt/ -e	the project	das
Spitze/ -n	the lace	die
Benzin	the gasoline, gas, petrol (no plural)	das
Bürger/ -	the citizen	der
Dummkopf/ -"e	dumb person, idiot ('Du_')	der
Holz	the wood (no plural)	das
Dienstag/ -e	the Tuesday	der
Mittag/ -e	the noon	der
Fabrik/ -en	the factory	die
Leiter/ -n	the ladder	die
Leiter/ -	the leader, the manager	der
Leiter/ -n	the ladder	die
Schlange/ -n	the snake	die
Zucker	the sugar (no plural)	der
en	to serve, to be used as	die
Wissenschaftler/ -	the academic	der
Fett	the fat (no plural)	das
Regel/ -n	the rule	die
Gegenteil/ -e	the opposite (Gegensatz, ... )	das
Artikel/ -	the article	der
Kilometer/ -	the kilometer	der
Freundschaft/ -en	the friendship	die
Reifen/ -	the tyre	der
Aufnahme/ -n	the admission, recording, reception	die
Feigling/ -e	the coward	der
Markt/ -"e	the market	der
Wirklichkeit	the reality (no plural) ('Realität' or ...)	die
Ware/ -n	the merchandise	die
Sitz/ -e	the seat, headquarters	der
Gesundheit	the health (no plural)	die
Eile	the hurry, the rush (no plural)	die
Sicht/ -en	sight, visibility, view (range of vision) (also figurative).	die
Unterstützung/ -en	the support	die
Ratte/ -n	the rat	die
Gedächtnis/ -se	the memory ('Erinnerung' or ...)	das
Auftritt/ -e	appearance (on stage), performance	der
Sand	the sand (no plural)	der
Stellung/ -en	the job position	die
Theorie/ -n	the theory	die
Arbeiter/ -	the worker ('Ar_')	der
Lärm	the noise, fuss (not 'G...'. 'K...') (no plural)	der
Mittagessen/ -	the lunch, the noon meal	das
Hubschrauber/ -	the helicopter	der
Realität/ -en	the reality ('Wirklichkeit' or ...)	die
Verabredung/ -en	the appointment, the date ('Termin' or ...)	die
Stimmung/ -en	the mood, atmosphere, sentiment (Laune, Atmosphäre, or ...)	die
Tasse/ -n	the cup	die
Zweck/ -e	the purpose, aim, objective, intention	der
Urteil/ -e	the judgment	das
Manager/ -	the manager	der
Stärke/ -n	the strength	die
Donnerstag/ -e	the Thursday	der
Anteil/ -e	the amount, stake, share, proportion	der
Unterhaltung/ -en	the entertainment, conversation	die
Gepäck	the luggage (no plural)	das
Bahnhof/ -"e	the train station	der
Kreuz/ -e	the cross, crucifix, clubs (cards)	das
Text/ -e	the text	der
Mitglied/ -er	the member	das
enige	that (one), the (one) ('d_')	der
Schrank/ -"e	the closet, cupboard	der
Leitung/ -en	the line, lead, conduct, management	die
Start/ -s	the start (Anfang,Beginn, ... )	der
Ursache/ -n	the cause, reason ('Grund' or ...)	die
Figur/ -en	the figure, physique	die
Rauch	the smoke (no plural)	der
Schulter/ -n	the shoulder	die
Krebs	the cancer (no plural)	der
Einladung/ -en	the invitation	die
Gerät/ -e	the device, appliance (not 'V...', 'E...')	das
Information/ -en	the information ('I_')	die
Wut	the anger, the rage ('Zorn' or ...) (no plural)	die
Farm/ -en	the farm ('F_')	die
Jahrhundert/ -e	the century	das
Virus/ die Viren	the virus	der
Humor	the humor (no plural)	der
Geräusch/ -e	the noise (countable)	das
Japan/ -	Japan	das
Suppe/ -n	the soup	die
Schokolade	the chocolate (no plural)	die
Miete/ -n	the rent	die
Pizza/ -s	the pizza	die
Gegner/ -	the opponent/ the adversary	der
Basis/ die Basen	the basis	die
Stahl/ -"e	the steel	der
Viertel/ -	the quarter (measure)	das
Einstellung/ -en	the adjustment, setting, attitude	die
Verdacht/ -"e	the suspicion (not 'M...')	der
Krone/ -n	the crown	die
Kindheit/ -en	the childhood	die
Hügel/ -	the hill	der
Fan/ -s	the fan	der
Museum/ die Museen	the museum	das
Nation/ -en	the nation	die
Einkaufen/ die Einkäufe	the shopping	das
Ausweis/ -e	the identity card (A~)	der
Käse	the cheese (no plural)	der
Kreis/ -e	the circle	der
Mauer/ -n	the wall (outdoors)	die
Puppe/ -n	the doll	die
Universität/ -en	the university	die
September	September	der
Schild/ -er	1. the shield. 2. the sign.	das
Klavier/ -e	the piano	das
Belohnung/ -en	the reward	die
Weihnachtsmann	the Santa Claus (no plural)	der
Küste/ -n	the coast	die
Warnung/ -en	the warning	die
Patient/ -en/ -en	the patient	der
Dusche/ -n	the shower (for washing)	die
Zugang/ -"e	the access	der
Schreibtisch/ -e	the desk	der
Hitze	the heat (no plural)	die
Kühlschrank/ -"e	the refrigerator	der
Hammer/ -"	the hammer	der
Fieber/ -	the fever	das
Koch/ -"e	the male cook	der
Material/ -ien	the material ('Stoff' or ...)	das
Juli	the July (no plural)	der
Behandlung/ -en	the treatment, dealing, handling (not 'Bearbeitung')	die
April	the April (no plural)	der
Neigung/ -en	tendency, tilt, inclination (angle)	die
Unterricht	the lesson (not 'L...')	der
Verlust/ -e	the loss	der
Regisseur/ -e	the film director	der
Stress	the stress (no plural)	der
Konto/ -s	the account (finance)	das
Modell/ -e	the model	das
Charakter/ -e	the character, temper, nature	der
Religion/ -en	the religion	die
Witwe/ -n	the widow	die
Stiefel/ -	the boot	der
Sport	the sports, athletics (no plural)	der
Apparat/ -e	the apparatus, the appliance	der
Versicherung/ -en	the insurance	die
Ankunft/ -"e	the arrival	die
Schock/ -s	the shock (noun)	der
Hafen/ -"	the harbour	der
Konzert/ -e	the concert	das
Störung/ -en	the disturbance	die
Gewicht/ -e	the weight	das
Widerstand/ -"e	the resistance, resistor (elec.) opposition	der
August	the August (no plural)	der
Paradies/ -e	the paradise	das
Turm/ -"e	the tower	der
Trainer/ -	the coach	der
Entfernung/ -en	the distance (not 'A...', 'F...', 'D...', 'S...')	die
Werbung/ -en	the advertising, advertisement	die
Empfang/ -"e	the reception ('E~')	der
Führung/ -en	the guided tour	die
Kunde/ -n/ -n	the male customer	der
Wäsche	the laundry (no plural)	die
Führerschein/ -e	the driving license ('Fü_')	der
Rad/ -"er	the wheel, the bike	das
Truppe/ -n	1. the combat squad 2. the troupe or (acting, dancing) company	die
Pfarrer/ -	the pastor	der
Quelle/ -n	the source	die
Esel/ -	the donkey	der
Kopfschmerzen	the headache	die
Roman/ -e	the novel	der
Technik/ -en	the technology ('Technologie' or ...)	die
Befürchtung/ -en	the fear, apprehension, worry (not 'Angst')	die
Netz/ -e	the net	das
Zentrum/ die Zentren	the centre	das
Huhn/ -"er	the hen (not 'W...')	das
Ergebnis/ -se	the result	das
Blume/ -n	the flower	die
Uni/ -s	the university (colloquial)	die
Atmosphäre/ -n	the atmosphere ('Stimmung' or ...)	die
Abenteuer/ -	the adventure	das
Abschied/ -e	the farewell	der
Minister/ -	the minister	der
Gemeinde/ -n	the municipality, community	die
Einfluss/ -"e	the influence	der
Verdienst/ -e	the pay, the wages ('Lohn', ...)	der
Satz/ -"e	the sentence	der
Dutzend/ -e	the dozen	das
Zorn	the anger, the rage ('Wut' or ...) (no plural)	der
Antrag/ -"e	the application, proposal, request	der
Bau/ die Bauten	the construction (Einrichtung, Konstruktion, Aufbau, or ...)	der
Bibel/ -n	the bible	die
Phase/ -n	the phase	die
Wille/ -n	the will	der
Kutsche/ -n	the horse carriage	die
Hai/ -e	the shark (only one syllable)	der
Tagebuch/ -"er	the diary	das
Sekretärin/ -nen	the female secretary	die
elbe/ dasselbe/ dieselbe	the same (three forms)	der
Mitarbeiter/ -	the employee ('M_')	der
Laune/ -n	the mood (of a person)	die
Verkehr	the traffic (no plural)	der
Badezimmer/ -	the bathroom	das
Steuer/ -	the rudder (not 'R...')	das
Kanal/ -"e	the channel, the canal	der
Steuer/ -n	the tax	die
Ausdruck/ -"e	the expression (print / edition)	der
Bart/ "-e	the beard	der
Beteiligung / -en	the sharing, involvement	die
Schmuck	the jewelry (no plural)	der
Appetit	the appetite (no plural)	der
Begriff/ -e	the concept ('B_')	der
Autor/ -en	the author	der
Transparenz	the transparency (no plural)	die
Mittwoch/ -e	the Wednesday	der
Maus/ -"e	the mouse	die
Jäger/ -	the hunter	der
Aussicht/ -en	the prospect, view, outlook (Ansicht, Ausblick, or ...)	die
Fahrrad/ -"er	the bicycle	das
Jude/ -n/ -n	the male Jew	der
Gewinn/ -e	the gain	der
Schuh/ -e	the shoe	der
Teller/ -	the plate (crockery)	der
Frühling/ -e	the spring (not Frühjahr)	der
Hinweis/ -e	evidence, clue, hint, tip, lead ('H_')	der
Gitarre/ -n	the guitar	die
Wolle	the wool (no plural)	die
Cola/ -s	the cola	die
Platte/ -n	the plate, the platter, the panel	die
Heirat/ -en	the marriage ('H_')	die
Zuschauer/ -	the viewer, the spectator	der
Gegenwart	the present time (no plural)	die
Juni	the June (no plural)	der
Lohn/ -e	the pay, the wages ('Verdienst', ... )	der
Bär/ -en/ -en	the bear	der
Tal/ -"er	the valley	das
Salz/ -e	the salt	das
Vorteil/ -e	the advantage	der
Nebel/ -	the mist, fog, haze	der
Psychiater/ -	the psychiatrist	der
Beginn	the beginning ('B_') (no plural)	der
Affe/ -n/ -n	the ape, the monkey	der
Toast/ -s	the toast (heated bread)	der
Scheibe/ -n	the slice	die
Bibliothek/ -en	the library	die
Ehefrau/ -en	the wife, spouse (female) (Frau, Gattin, or ...)	die
Daumen/ -	the thumb	der
Fahrzeug/ -e	the vehicle	das
Ferien	the vacation (plural only) (usually school vacation)	die
Personal	the staff, the personnel (no plural)	das
Besucher/ -	the visitor	der
Motorrad/ -"er	the motorcycle	das
Käfig/ -e	the cage	der
Generation/ -en	the generation	die
Ausgang/ -"e	the exit (of a building, area, etc.), outcome (result), outlet (electrical), output (of a circuit, device)	der
Zaun/ -"e	the fence	der
Fantasie/ -n	the fantasy/ the imagination	die
Garage/ -n	the garage	die
Brieftasche/ -n	the wallet ('B_')	die
Unterschrift/ -en	the signature	die
Anzeige/ -n	the newspaper ad	die
Abschluss/ -"e	graduation, degree, conclusion, completion, closure ('A_')	der
Tropfen/ -	the drop of liquid	der
Aufzug/ -"e	the lift, the elevator	der
Ozean/ -e	the ocean ('O_')	der
Durst	the thirst (no plural)	der
Lampe/ -n	the lamp	die
Café/ -s	the café	das
Musiker/ -	the male musician	der
Ausbildung/ -en	the apprenticeship, training, education, schooling	die
Geschwindigkeit/ -en	the speed	die
Saft/ -"e	the juice	der
Aktion/ -en	the action, campaign ('A_')	die
Teppich/ -e	the carpet, the rug	der
Leine/ -n	the leash	die
Umgebung/ -en	the surrounding area ('Umfeld', 'Umwelt', or ...)	die
Profi/ -s	the pro	der
Handel	the trade (no plural)	der
Fleck/ -en	the spot	der
Leistung/ -en	the performance, achievement, accomplishment, power	die
Stufe/ -n	the level ('S_')	die
Unterwäsche	the underwear (plural only)	die
Partei/ -en	the political party	die
Eingang/ -"e	the entrance to a building, inlet, doorway, access	der
Zone/ -n	the zone	die
Seife/ -n	the soap	die
Oper/ -n	the opera	die
Service	the service (no plural) (S~)	der
Kultur/ -en	the culture	die
Tradition/ -en	the tradition	die
Mannschaft/ -en	the team (Team, or ...)	die
Bewusstsein	the consciousness (no plural)	das
Rettung/ -en	the rescue	die
Alptraum/ -"e	the nightmare	der
Objekt/ -e	the object	das
Stirn/ -en	the forehead	die
Technologie/ -n	the technology ('Technik' or ...)	die
Saal/ die Säle	the hall (big room)	der
Strecke/ -n	the distance ('s..')	die
Gedicht/ -e	the poem	das
Krise/ -n	the crisis	die
Handtuch/ -"er	the towel	das
Schriftsteller/ -	the writer (Autor, Verfasser, or ...)	der
Experiment/ -e	the experiment (Versuch, Probe, or ...)	das
Zelt/ -e	the tent	das
Zettel/ -	the slip/piece of paper, note, bill	der
Verständnis/ -se	the comprehension, understanding ('Verstehen" or ... ('V_')	das
Experte/ -n/ -n	the male expert	der
Butter	the butter (no plural)	die
Krawatte/ -n	the tie ('K_')	die
Interview/ -s	the interview (not for a job)	das
Parkplatz/ -"e	the parking space, the parking lot	der
Symbol/ -e	the symbol	das
Marke/ -n	the brand, label, make, mark (of a product)	die
November	the November (no plural)	der
Tragödie/ -n	the tragedy	die
Vergleich/ -e	the comparison	der
Kabel/ -	the cable, the wire	das
Summe/ -n	the sum	die
Amt/ -"er	the department, office, bureau ('Büro' or ...)	das
Schnaps/ -"e	the schnapps, the hard liquor	der
Blatt/ -"er	the leaf, the piece of paper	das
Golf	the golf (no plural)	das
Pfeife/ -n	the pipe (for smoking)/ the whistle	die
Zahnarzt/ -"e	the dentist	der
Kostüm/ -e	the Costume, a woman's suit	das
Motiv/ -e	the motive, the motif	das
Prüfung/ -en	the exam (Examen, or ...)	die
Ereignis/ -se	the event, incident, occurence ('E_')	das
Kater/ -	the hangover	der
Kofferraum/ -"e	the trunk (of a car), luggage trunk, the boot	der
Futter/ -	the animal feed	das
Kellner/ -	the waiter	der
Verhandlung/ -en	the negotiation, trial, conference	die
Telefonnummer/ -n	the telephone number	die
Reis	the rice (no plural)	der
Brett/ -er	the board/ the plank	das
Internet	the internet (no plural)	das
März	the March (no plural)	der
Rand/ -"er	the edge	der
Märchen/ -	the fairy tale	das
Reiter/ -	the horseback rider	der
Erwachsene/ -n	the female adult	die
Erwachsene/ -n	the male adult	der
Serie/ -n	the TV series	die
Lautsprecher/ -	the loudspeaker	der
Kombination/ -en	the combination	die
Verspätung/ -en	the delay	die
Temperatur/ -en	the temperature	die
Forschung/ -en	the research (Recherche, Erkundung, Erforschung, or ...)	die
Kollege/ -n/ -n	the colleague	der
Wunde/ -n	the wound	die
Bevölkerung/ -en	the population	die
Persönlichkeit/ -en	the personality	die
Schneider/ -	the tailor	der
Villa/ die Villen	the villa	die
Jubiläum/ - die Jubiläen	The anniversary, jubilee (not 'Jahrestag')	das
Stamm/ -"e	the stem, tribe, trunk (tree)	der
Ansicht/ -en	the opinion, notion, view, belief ('An_')	die
Tankstelle/ -n	the petrol station	die
Klage/ -n	the action (law), claim (law), complaint (law), legal action, suit ('K_')	die
Akt/ -e	1. the act (of an opera, etc.) 2. the nude (in art)	der
Zahn/ -"e	the tooth	der
Wettbewerb/ -e	the competition, contest	der
Enkel/ -	the grandson, the grandchild	der
Couch/ -es	the couch	die
Sofa/ -s	the sofa	das
Gehalt/ -"er	the salary, wage	das
Mutti/ -s	the mama, mom, mum (not Mama)	die
Saison/ -s	the season (Jahreszeit, ... )	die
Wohnzimmer/ -	the living room	das
Republik/ -en	the republic	die
Eimer/ -	the bucket	der
Ufer/ -	the bank (of a river, etc.)	das
Abstand/ -"e	the distance, gap	der
Jury/ -s	the jury	die
Welle/ -n	the wave	die
Flur/ -en	the meadow, field (not Wiese)	die
Flur/ -e	the hall, the corridor ('F_')	der
Ausnahme/ -n	the exception	die
Rasen/ -	the lawn	der
Lkw/ -s	the truck (colloquial)	der
Schach	the chess (no plural)	das
Brand/ -"e	the fire ('Feuer' or ...)	der
Bauer/ -n/ -n	the farmer ('B_')	der
Demokratie/ -n	the democracy	die
Therapie/ -n	the therapy	die
Rezept/ -e	the recipe	das
Produktion/ -en	the production	die
Landung/ -en	the landing	die
Vertreter/ -	the representative, proxy, agent (pol.) deputy (V_)	der
Nachbar/ -n/ -n	the male neighbour	der
Steak/ -s	the steak	das
Nichte/ -n	the niece	die
Umschlag/ -"e	the envelope (mail), cover	der
Kaninchen/ -	the rabbit ('K_')	das
Versammlung/ -en	the assembly, gathering, convention, session	die
Pfad/ -e	the path	der
Ausland/ -"er	the foreign land	das
Datum/ die Daten	the date	das
Magazin/ -e	the magazine (not Z...)	das
Kompliment/ -e	the compliment	das
Januar	the January (no plural)	der
Fähigkeit/ -en	the ability, skill, capability	die
Spaziergang/ -"e	the walk	der
Japaner/ -	the Japanese (person)	der
Gürtel/ -	the belt	der
Zigarre/ -n	the cigar	die
Salat/ -e	the salad	der
Krankenschwester/ -n	the nurse (female)	die
Mode/ -n	the fashion	die
Erfindung/ -en	the invention	die
Möbel	the furniture (plural only)	die
Ente/ -n	the duck	die
Weltkrieg/ -e	the world war	der
Wurm/ -"er	the worm	der
Mütze/ -n	the yarn winter head cover cap	die
Neffe/ -n/ -n	the nephew	der
Studium/ die Studien	the study, the studies, studying, scholastics	das
Produkt/ -e	the product	das
Eisen	the iron (a type of metal) (no plural)	das
Bude/ -n	the outdoor booth, the stall, the stand, the hut	die
Halloween/ -s	the Halloween	das
Anlage/ -n	the facility/ the construction/ the installation	die
Kasse/ -n	the till, the cash register	die
Fußball/ -"e	the football, (the) soccer (ball)	der
Bekannte/ -n	the female acquaintance	die
Politiker/ -	the politician	der
Tüte/ -n	the bag ('Tasche' or ...)	die
Schein/ -e	the bill (USA)/ bank note	der
Liter/ -	the liter	der
Friseur/ -e	the male hair stylist	der
Diskussion/ -en	the discussion	die
Anzahl	the quantity (no plural) (Menge, ... )	die
Trinkgeld/ -er	the tip, gratuity (for services in a restaurant, club, bar)	das
Fahne/ -n	the flag	die
Erzähler/ -	the male narrator	der
Münze/ -n	the coin	die
Paket/ -e	the parcel, package, packet (not Packung)	das
Diebstahl/ -"e	the theft	der
Donner	the thunder (no plural)	der
Herbst/ -e	the fall, autumn	der
Betrieb/ -e	the plant, the enterprise, firm, business ('B_')	der
Gegensatz/ -"e	the opposite (Gegenteil, ... )	der
Wirtschaft/ -en	the economy	die
Anlass/ -"e	the occasion (Gelegenheit, or ...)	der
Rang/ -"e	the rank	der
Zentimeter	the centimeter (no plural)	der
Bach/ -"e	the stream	der
Vati/ -s	the dad	der
Kissen/ -	the pillow	das
Werkstatt/ -"en	the workshop	die
Konferenz/ -en	the conference, meeting	die
Ausflug/ -"e	the trip, excursion, getaway, outing, jaunt ('A_')	der
Assistent/ -en/ -en	the assistant	der
Bargeld	the cash (no plural)	das
Gemälde/ -	the painting	das
Hahn/ -"e	the rooster	der
Sänger/ -	the male singer	der
Verwandte/ -n	the male relative	der
Rente/ -n	the pension ('R_')	die
Stall/ -"e	the stable, stall	der
Verwandte/ -n	the female relative	die
Länge/ -n	the length	die
Missverständnis/ -se	the misunderstanding	das
Haltung/ -en	the stance, attitude, posture ('Einstellung' or ...)	die
Medien	the media (plural only)	die
Frisur/ -en	the hairstyle	die
Zeugin/ -nen	the female witness	die
Eifersucht	the jealousy (no plural)	die
Honig	the honey (no plural)	der
Irre/ -n	the lunatic, crazy person ('I_')	der
Detektiv/ -e	the detective	der
Kleingeld/ -er	the change (as in money) ('K_')	das
Werkzeug/ -e	the tool	das
Tabak/ -e	the tobacco	der
Gestalt/ -en	the shape, figure (personality, character in a novel) form	die
Kredit/ -e	the credit	der
Rollstuhl/ -"e	the wheelchair	der
Metall/ -e	the metal	das
Geschäftsmann/ -"er	the businessman, (not Kaufmann)	der
Apfel/ -"	the apple	der
Krach/ -"e	the noise (no plural), racket, row	der
Orange/ -n	the orange	die
CD/ -s	the compact disc	die
Feuerwehr/ -en	the fire brigade	die
Gramm/ -e	the gram	das
Schublade/ -n	the drawer	die
Kosmos/ die Kosmen	the cosmos	der
Kneipe/ -n	the bar, pub, tavern	die
Konzept/ -e	the concept ('K_')	das
Bezug/ -"e	the reference, pillow/cushion cover	der
Schwager	the brother-in-law	der
Gemüse	the vegetables (no plural)	das
Gemeinschaft/ -en	the community, fellowship	die
Aufenthalt/ -e	the stopover, the stay, the residence	der
Praxis/ die Praxen	the practice (medical, etc.)	die
Silber	the silver, (no plural)	das
Topf/ -"e	the pot	der
Autorität/ -en	the authority (Behörde, ... )	die
Qualität/ -en	the quality	die
Hinsicht/ -en	the respect, regard ('Respekt' or ...)	die
Autounfall/ -"e	the car accident	der
Einbrecher/ -	the male burglar	der
Fuchs/ -"e	the fox	der
Teenager/ -	the teenager	der
Konkurrenz/ -en	the competition (spelling Bee), competitive, rivalry (i.e. a competing business, sports team, etc)	die
Babysitter/ -	the babysitter	der
Maler/ -	the painter	der
Dose/ -n	the can	die
Fortschritt/ -e	the progress	der
Lastwagen/ -	the truck, the lorry	der
Tango/ -s	the tango	der
Löffel/ -	the spoon	der
Schicht/ -en	the layer, shift (work shift), stratum (of earth)	die
Burg/ -en	the castle ('B_')	die
Wohnwagen/ -	The RV, Trailer, caravan	der
Buchhalter/ -	the bookkeeper	der
Dampf/ -"e	the steam	der
Euro/ -s	the euro	der
Garderobe/ -n	the dressing room (not 'U...')	die
Italiener/ -	the male Italian person	der
Schoß/ -"e	the lap (of one's legs)	der
Schweiz	the Switzerland (no plural)	die
Schere/ -n	the scissors	die
Sprecher/ -	the speaker	der
Wende/ -n	the turn, turnaround, reversal, turning point, rebound	die
Auswahl/ -en	the choice, selection, variety	die
Mangel/ -"	the lack	der
Branche/ -n	the branch	die
Beschreibung/ -en	the description, specification	die
Hauptstadt/ -"e	the capital city	die
Rekord/ -e	the record ('R...')	der
Verkäufer/ -	the salesman	der
Detail/ -s	the detail	das
Torte/ -n	the cake, pie, tart	die
Kreditkarte/ -n	the credit card	die
Analyse/ -n	the analysis	die
Student/ -en/ -en	the student	der
Autobahn/ -en	the interstate, highway, motorway	die
Masse/ -n	Mass, bulk, crowd	die
Strategie/ -n	the strategy	die
Kommission/ -en	the commission	die
Zeile/ -n	the line of text	die
Messe/ -n	1. the mass (a type of musical composition) 2. the trade fair	die
Vorhang/ -"e	the curtain	der
Braten/ -	the roast meat, the roast	der
Eintritt/ -e	the entrance, occurrence, admission (to an event/show)	der
Farmer/ -	the farmer ('F_')	der
Adler/ -	the eagle	der
Niederlage/ -n	the defeat	die
Jazz	the jazz (no plural)	der
Ausrede/ -n	the excuse	die
Fähre/ -n	the ferry	die
Zoll/ -"e	the customs (at an airport)	der
Stadion/ die Stadien	the stadium	das
Schaf/ -e	the sheep	das
Alternative/ -n	the alternative	die
Griechenland	the Greece (no plural)	das
Löwe/ -n	the lion	der
Zeitschrift/ -en	the magazine, journal, periodical	die
Hamburger/ -	the hamburger	der
Anschlag/ -"e	the attack ('Angriff' or ...)	der
Ober/ -	the (head) waiter	der
Tuch/ -e	cloth, scarf, blanket, towel	das
Becher/ -	the beaker, the cup	der
Abschnitt/ -e	stage, segment , paragraph, article, section, passage	der
Zahlung/ -en	the payment	die
Blei	the lead (an element) (no plural)	das
Lippenstift/ -e	the lipstick	der
Landschaft/ -en	the landscape	die
Hausmeister/ -	the janitor, the caretaker	der
Haken/ -	the hook, peg, snag, hitch (a problem)	der
Bewohner/ -	the inhabitant ('B_')	der
Hobby/ -s	the hobby	das
Venus	the Venus (no plural)	die
Busch/ -"e	the bush	der
Handtasche/ -n	the handbag	die
Tänzer/ -	the dancer	der
Ingenieur/ -e	the male engineer	der
Händler/ -	the merchant, retailer, dealer	der
Union/ -en	the union	die
Kamin/ -e	the chimney, fireplace, mantle (Schornstein, or ...)	der
Taschentuch/ -"er	the handkerchief	das
Kapelle/ -n	the chapel, the band	die
Note/ -n	the mark, the grade, the musical note	die
Feder/ -n	the feather	die
Kerze/ -n	the candle	die
Zeitalter/ -	the era, epoch, age (Epoche, Zeitraum, or ...)	das
Ausländer/ -	the foreigner (not 'Fremder')	der
Wolke/ -n	the cloud	die
Armut	the poverty (no plural)	die
Seemann/ -"er	the seaman	der
Lebensmittel/ -	the food, the groceries	das
Klub/ -s	the club ('Club', ..., 'Verein')	der
Sängerin/ -nen	the female singer	die
Chor/ -"e	the choir	der
Komödie/ -n	the comedy	die
Einrichtung/ -en	the establishment, institution, device	die
Balkon/ -e	the balcony	der
Abfall/ -"e	waste, refuse, garbage, rubbish (Müll)	der
Ausgabe/ -n	the expense, expenditure, edition (publishing), issuance	die
Einwohner/ -	the inhabitant ('E_')	der
Fahrkarte/ -n	the ticket (for a train / bus)	die
Kinn/ -e	the chin	das
Freizeit/ -en	the free time	die
Gewitter/ -	the thunderstorm	das
Handschrift/ -en	the handwriting	die
Pflanze/ -n	the plant	die
Nachtisch/ -e	the dessert (not D...)	der
Luxus	the luxury (no plural)	der
Orchester/ -	the orchestra	das
Fach/ -"er	the field of study, the subject	das
Dokument/ -e	the document	das
Treffpunkt/ -e	the meeting place	der
Bräutigam/ -e	the bridegroom	der
Picknick/ -s	the picnic	das
Klimaanlage/ -n	the air conditioning	die
Börse/ -n	the stock market ('B-')	die
Kennzeichen/ -	the label, the distinguishing mark	das
Russe/ -n/ -n	the male Russian person	der
Fotograf/ -en/ -en	the photographer	der
Lamm/ -"er	the lamb	das
Plastik	the plastic (no plural)	das
Umwelt/ -en	the environment, surroundings, surrounding area (Umfeld, Umgebung, or ...)	die
Effekt/ -e	the effect, the impact	der
Wechsel/ -	the change ('w_')	der
Schrift/ -en	the font, writing (handwriting, typeface, etc.), script	die
Zinsen	the bank interest (plural only)	die
Soße/ -n	the sauce	die
Pension/ -en	the pension ('P_')	die
Beamte/ -n	the civil servant	der
Kasten/ -"	the case, the box	der
Geschlecht/ -er	the gender	das
Passagier/ -e	the passenger ('P_')	der
Feuerwerk/ -e	the fireworks	das
Kurve/ -n	the curve	die
Journalist/ -en/ -en	the journalist	der
Bedürfnis/ -se	the need, requirement (not 'A_,' 'N_')	das
Kaiserin/ -nen	the empress	die
Bekannte/ -n	the male acquaintance	der
Apotheke/ -n	the pharmacy	die
Geige/ -n	the violin	die
Bildung/ -en	the education	die
Produzent/ -en/ -en	the producer	der
Lehre/ -n	the apprenticeship	die
Kamm/ -"e	the comb	der
Hörer/ -	the listener, the (telephone) receiver	der
Verletzung/ -en	the injury	die
Verband/ -"e	the bandage, association, union, syndicate	der
Kommunikation/ -en	the communication	die
Chemie/ -n	the chemistry	die
Abkürzung/ -en (Abk.)	the abbreviation (abbr.)	die
Bestimmung/ -en	the provision, purpose, determination, determining, term (not 'Bed_')	die
Weltraum	the outer space (no plural) (All, Weltall, or ...)	der
Supermarkt/ -"e	the supermarket	der
Pille/ -n	the pill (Tablette or ...)	die
Nerv/ -en	the nerve	der
Leder/ -	the leather	das
Zusammenarbeit	the collaboration, cooperation (not K..., M...)	die
Unterkunft/ -"e	the accommodation, housing, lodging	die
Vorschrift/ -en	the provision, regulation, rule	die
Reinigung/ -en	the purification/ the cleansing/ the dry cleaning	die
Vorname/ -ns/ -n	the first name, given name	der
Mechaniker/ -	the mechanic	der
Rathaus/ -"er	the city hall	das
Provinz/ -en	the province	die
Badewanne/ -n	the bathtub	die
Formel/ -n	the formula	die
Klima/ -ta	the climate	das
Uhrzeit/ -en	the time of day	die
Literatur/ -en	the literature	die
Erziehung/ -en	the upbringing	die
BH/ -s	the bra	der
Obst	the fruit (no plural)	das
Hase/ -n/ -n	the hare, the rabbit	der
Notruf/ -e	the emergency phone call/ the distress call	der
Feierabend/ -e	the end of the work day	der
Kritik/ -en	the criticism	die
Senf/ -e	the mustard	der
Kaviar	the caviar (no plural)	der
Rückseite/ -n	the backside	die
Kreuzung/ -en	the junction, crossing, crossroads, intersection ('Übergang' or ...)	die
Handschuh/ -e	the glove	der
Rucksack/ -"e	the backpack	der
Drama/ die Dramen	the drama	das
Umgang/ -"e	the handling, dealings, contact	der
Vase/ -n	the vase	die
Schal/ -e or -s	the scarf	der
Nachbarin/ -nen	the female neighbour	die
Jeans/ -	the jeans	die
Triumph/ -e	the triumph	der
Terror/ -s	the terror	der
Schnurrbart/ -"e	the moustache	der
Spaghetti	the spaghetti (plural only)	die
Kalender/ -	the calendar	der
Patrouille/ -n	the patrol	die
Quittung/ -en	the receipt	die
Durchsage/ -n	the announcement (D_)	die
Strafzettel/ -	the traffic ticket	der
Ratschlag/ -"e	the advice, counsel (Rat, Beratung, ...)	der
Rechtsanwalt/ -"e	the male lawyer	der
Kellnerin/ -nen	the waitress	die
Inhalt/ -e	the content	der
Gewohnheit/ -en	the custom, the habit	die
Käufer/ -	the buyer	der
Betrag/ -"e	the amount, ('B_')	der
Terrorismus	the terrorism (no plural)	der
Element/ -e	the element	das
Milliarde/ -n	the billion	die
Seide	the silk (no plural)	die
Bildschirm/ -e	the monitor, the screen	der
Notaufnahme/ -n	the emergency room (hospital)	die
Gruß/ -"e	the salutation (singular), the regards (plural)	der
Jahreszeit/ -en	the season (Saison, ... )	die
Mathematik	the mathematics (no plural)	die
Höflichkeit/ -en	the courtesy	die
Spezialität/ -en	the specialty	die
Alliierten	the Allies (WWII) (plural only)	die
Anrufbeantworter/ -	the answering machine	der
Mitbewohner/ -	the housemate, the roommate	der
Wurst/ -"e	the sausage	die
Argument/ -e	the argument ('Ar_')	das
Umarmung/ -en	the hug, the embrace	die
Bund/ -"e	the association/ the league (B~)	der
Streichholz/ -"er	the wooden match (for lighting cigarettes, etc.)	das
Schweiß	the sweat (no plural)	der
Dauer	the duration (no plural)	die
Schüssel/ -n	the bowl	die
Geiger/ -	the male violinist	der
Geschwister/ -	the sibling	das
Kritiker/ -	the male critic	der
Haushalt/ -e	the household	der
Nachfrage/ -n	the demand (not 'F...')	die
Geiger/ -	the violinist ('Violinist' or ...)	der
Terrorist/ -en/ -en	the terrorist	der
Notiz/ -en	the note, memo, quote (stocks)	die
Gipfel/ -	the summit, the top	der
Weltall	the universe, outer space (no plural) (Universum, Weltraum, or ...)	das
Packung/ -en	the package, pack, packet (not 'das P...')	die
Drittel/ -	the third	das
Gastgeber/ -	the host	der
Unterhose/ -n	the underwear, underpants (not Unterwäsche)	die
Mittagspause/ -n	the lunch break	die
Feuerwehrmann/ -"er	the fireman	der
Gärtner/ -	the (male) gardener	der
Galerie/ -n	the gallery	die
Pfennig/ -e	the penny	der
Tennis	the tennis (no plural)	das
Damm/ -"e	the dam (not 'S...')	der
Abflug/ -"e	the departure (airplane)	der
Pullover/ -	the sweater (long form)	der
Comic/ -s	the comic	der
Armband/ -"er	the bracelet	das
Zahnbürste/ -n	the toothbrush	die
Phänomen/ -e	the phenomenon	das
Pflaster/ -	the plaster, the adhesive tape	das
Telefonbuch/ -"er	the telephone directory	das
Reihenfolge/ -n	the order, sequence, chronology	die
Fernbedienung/ -en	the remote control	die
Abfahrt/ -en	the departure (bus)	die
Sessel/ -	the armchair -"not Lehnstuhl"	der
Kondom/ -e	the condom	das
Formular/ -e	the blank form	das
Instrument/ -e	the instrument	das
Brötchen/ -	the (bread)roll	das
Exemplar/ -e	the copy (of a book, etc.)	das
Geschirr	the dishes, the dinnerware (no plural)	das
Chaos	chaos, mayhem, disorder	das
Galaxie/ -n	the galaxy	die
Klingel/ -n	the (door)bell	die
Bluse/ -n	the blouse	die
Konflikt/ -e	the conflict	der
Behörde/ -n	the authority (Autorität, ... )	die
Sekretär/ -e	the male secretary	der
Flugplatz/ -"e	the airfield	der
Orangensaft	the orange juice (no plural)	der
Mieter/ -	the renter	der
Ausstellung/ -en	the exhibition	die
Pudding/ -s	the pudding	der
Frost	the frost (no plural)	der
Klatsch	the gossip (no plural)	der
Popcorn	the popcorn (no plural)	das
Heizung/ -en	the (central) heating	die
Taschenlampe/ -n	the torch, the flashlight	die
Fels/ -en	the rock, crag, bluff (Felsen, or ...)	der
Physik	the physics (no plural)	die
Wecker/ -	the alarm clock	der
Biene/ -n	the bee	die
Diskette/ -n	the diskette	die
Kessel/ -	the boiler, cauldron, kettle	der
Outfit/ -s	the outfit (Anzug or ...)	das
Schilling/ -	the shilling (former Austrian currency)	der
Anschluss/ -"e	the connection (TV), port, terminal, line	der
Herd/ -e	the stove, oven, furnace, (Ofen, or ...)	der
Regal/ -e	the shelf	das
Semester/ -	the semester	das
Depression/ -en	the depression	die
Türkei	the Turkey (no plural)	die
Frühjahr/ -e	the spring (not Frühling)	das
Haustür/ -en	the front door	die
Erkältung/ -en	the common cold	die
Briefkasten/ -"	the mailbox	der
Industrie/ -n	the industry	die
Wohlstand	the prosperity, affluence (no plural)	der
Lupe/ -n	the magnifying glass, magnifier	die
Ski/ -er	the ski	der
Region/ -en	the region, county, area	die
Slip/ -s	the panties, the briefs	der
Ampel/ -n	the traffic light	die
Jugendliche/ -n	the female young person	die
Jugendliche/ -n	the male young person	der
Telefonzelle/ -n	the telephone booth	die
Klempner/ -	the plumber	der
Kanzler/ -	the male chancellor	der
Scanner/ -	the scanner	der
Stiefmutter/ -"	the stepmother	die
Investition/ -en	the investment	die
Arbeitszimmer/ -	the study (a room) ('Arbeitsraum' or ...)	das
Cousin/ -s	the male cousin	der
Kindergarten/ -"	the kindergarten	der
Vorwurf/ -"e	the reproach	der
Erzbischof/ -"e	the archbishop	der
Standort/ -e	the site, location, habitat	der
Maß/ -e	the measure, degree, extent, measurement	das
Sonnenbrille/ -n	the sun glasses	die
Zeichnung/ -en	the drawing	die
Erkenntnis/ -se	the insight, realisation, knowledge, recognition	die
Grausamkeit/ -en	the cruelty	die
Perspektive/ -n	the perspective	die
Getränk/ -e	the beverage	das
Schwägerin/ -nen	the sister-in-law	die
Verwendung/ -en	the usage, application, utilization ('V_')	die
Tierarzt/ -"e	the vet	der
Nuss/ -"e	the nut	die
Architekt/ -en/ -en	the architect	der
Verein/ -e	The Association, the club ('Club', 'Klub', ...)	der
Tonne/ -n	the ton, barrel, bin	die
Einkaufszentrum/ die Einkaufszentren	the shopping centre	das
Weihnachtsgeschenk/ -e	the Christmas present	das
Lumpen/ -	the rag	der
Aufsatz/ -"e	the essay, composition, article	der
Mehl	the flour (no plural)	das
Management/ -s	the management	das
Kanadier/ -	the Canadian person	der
Sowjetunion	the Soviet Union (no plural)	die
Schildkröte/ -n	the turtle, tortoise	die
Debatte/ -n	the debate	die
Dialog/ -e	the dialogue	der
Studie/ -n	the survey ('Umfrage', ... )	die
Schreck/ -e	the shock, fright, scare	der
Bedienung/ -en	the service in a restaurant, etc.	die
Veranstaltung/ -en	the event ('V_')	die
Forscher/ -	the researcher	der
Absatz/ -"e	the paragraph (Paragraph, ... )	der
Fußboden/ -"	the floor (not 'B...')	der
Verwaltung/ -en	the administration, maintenance (computer)	die
Arbeitgeber/ -	the employer	der
Kaufhaus/ -"er	the department store	das
Medikament/ -e	the drug, medicine, medicament	das
Bremse/ -n	the brake	die
Gleis/ -e	the train track, platform, rail, line	das
Hypothek/ -en	the mortgage	die
Terrasse/ -n	the terrace	die
Vorsitzende/ -n	the chairperson	der
Dom/ -e	the cathedral	der
Vulkan/ -e	the volcano	der
Niveau/ -s	the level ('N_')	das
Trompete/ -n	the trumpet	die
Filmstar/ -s	the filmstar	der
Stiefvater/ -"	the stepfather	der
Einkommen/ -	the income	das
Poster/ -	the poster	das
Enkelin/ -nen	the granddaughter	die
Gabel/ -n	the fork	die
Wachstum/ -"er	the growth	das
Dimension/ -en	the dimension	die
Aktentasche/ -n	the briefcase	die
Lehne/ -n	the rest: back rest, arm rest, etc.	die
Silvester/ -	the New Year's Eve	das
Designer/ -	the designer	der
Heimweg/ -e	the way home	der
Konzern/ -e	the concern	der
Wachs/ -e	the wax	das
Kopfhörer	the headphone	der
Haustier/ -e	the pet	das
Stockwerk/ -e	the floor of a multi-storey building (2 syllables)	das
Scheinwerfer/ -	the headlight, the floodlight	der
Pulli/ -s	the sweater (colloquial)	der
Oberst	the colonel	der
Taktik/ -en	the tactic, policy	die
Existenz/ -en	the existence (not 'S...')	die
Heiligabend/ -e	the Christmas Eve	der
Schreiber/ -	the clerk, scribe, writer	der
Künstlerin/ -nen	the female artist	die
Hausarbeit/ -en	the housework	die
Aufführung/ -en	the performance, recital	die
Architektur/ -en	the architecture	die
Mathe	the math (no plural)	die
Lenkrad/ -"er	the steering wheel ('L_')	das
Bündel/ -	the bundle	das
Ostern	the Easter (no plural)	das
Fassade/ -n	the facade	die
Cousine/ -n	the female cousin	die
Website/ -s	the website	die
Seide	the silk (no plural)	die
Beleuchtung/ -en	the lighting	die
Kronleuchter/ -	the chandelier	der
Abendbrot/ -e	the supper ('Abendessen' or ...)	das
Dachboden/ -"	the attic	der
Seminar/ -e	the seminar	das
Punk/ -s	the punk	der
Eigenschaft/ -en	the feature, property, characteristic, trait ('E_')	die
Diebin/ -nen	the female thief	die
Leser/ -	the reader	der
Malerei	The act of painting (no plural)	die
Matrose/ -n/ -n	the sailor	der
Mehrheit/ -en	the majority ('Mehrzahl,' 'Großteil' or ... 'M_')	die
Hausfrau/ -en	the housewife	die
Lebensunterhalt	means of subsistence, livelihood, one's living (no plural)	der
Kandidat/ -en/ -en	the candidate	der
Darstellung/ -en	the presentation, representation, display	die
Freundlichkeit	the friendliness (no plural)	die
Banane/ -n	the banana	die
Nachthemd/ -en	the nightgown, night-dress, nightshirt	das
Elefant/ -en/ -en	the elephant	der
Einhorn/ -"er	the unicorn	das
Feiertag/ -e	the public holiday ('Festtag' or ...)	der
Tablette/ -n	the pill, the tablet (Pille or ...)	die
Parlament/ -e	the parliament	das
Schiedsrichter/ -	the referee	der
Auskunft/ -"e	the information ('A_')	die
Arbeitsplatz/ -"e	the place of work	der
Ochse/ -n	the ox	der
Tourist/ -en/ -en	the tourist	der
Chefin/ -nen	the female boss	die
Grundschule/ -n	the elementary school, primary school	die
Krankenpflege	the nursing (no plural)	die
Entwurf/ -"e	the draft, outline, blueprint, design, plan	der
Klippe/ -n	the cliff	die
Teleskop/ -e	the telescope	das
Fax/ -e	the fax	das
Software/ -s	the software	die
Polizistin/ -nen	the female police officer	die
Gummi/ -s	the rubber (ambiguous meaning)	der
Sekt	sparkling wine, bubbly (no plural)	der
Postkarte/ -n	the postcard	die
Marmelade/ -n	the jam, jelly	die
Karton/ -s	cardboard, carton	der
Schwan/ -"e	the swan	der
Teilnehmer/ -	the participant	der
Schnecke/ -n	the snail	die
Planung/ -en	the planning	die
Jüdin/ -nen	the female Jew	die
Campus/ -	the campus	der
Ellbogen/ -	the elbow	der
Schwiegermutter/ -"	the mother-in-law	die
Durchschnitt/ -e	the average	der
Vorlesung/ -en	the lecture, course (series of readings), reading (from a book) ('Vortrag' or ...)	die
Bleistift/ -e	the pencil	der
Flöte/ -n	the flute, whistle	die
Nordpol	the North Pole (no plural)	der
Lebenslauf/ -"e	the résumé, curriculum vitae, course of life	der
Kundin/ -nen	the female customer	die
Biologie	the biology (no plural)	die
Sensation/ -en	the sensation	die
Ausfahrt/ -en	the interstate / highway exit	die
Lippe/ -n	the lip	die
Alarmanlage/ -n	the alarm system	die
Notizbuch/ -"er	the diary, notebook	das
Institution/ -en	the institution	die
Stau/ -e	the congestion, traffic jam	der
Haarschnitt/ -e	the haircut	der
Einfahrt/ -en	the entrance to a highway, driveway	die
Schlagzeug/ -e	the drum set, percussion	das
Witwer/ -	the widower	der
Theaterstück/ -e	the theatrical play	das
Metzger/ -	the butcher ('M_')	der
Vegetarier/ -	the vegetarian	der
Wörterbuch/ -"er	the dictionary	das
Regenschirm/ -e	the umbrella	der
Mineralwasser/ -"	the mineral water (Sprudel, ... )	das
Wiese/ -n	the meadow, pasture (not Flur)	die
Geschäftspartner/ -	the business partner	der
Shampoo/ -s	the shampoo	das
Pfeffer	the pepper (no plural)	der
Waschmaschine/ -n	the washing machine	die
Speisekarte/ -n	the menu	die
Einwanderer/ -	the immigrant ('E_')	der
Mülleimer/ -	the dustbin, the garbage can (not 'A...')	der
Lebensversicherung/ -en	the life insurance	die
Theke/ -n	the bar (in a pub)/ the counter	die
Finanzen	the finances (plural only)	die
Krug/ -"e	the jug	der
Besserung/ -en	the improvement	die
Reißverschluss/ -"e	the zipper	der
Panne/ -n	the failure, the breakdown ('P_')	die
Kontinent/ -e	the continent	der
Schwiegervater/ -"	the father-in-law	der
Aktivität/ -en	the activity	die
Geburtstagsgeschenk/ -e	the birthday present	das
Mitbürger/ -	the fellow citizen	der
Shorts	the shorts (plural only)	die
Salami/ -s	the salami	die
Zahnpasta	the toothpaste (no plural)	die
Belastung/ -en	the burden, strain, load, charge (finance)	die
Kollegin/ -nen	the female colleague	die
Reklame/ -n	the advertisement (R...)	die
Reparatur/ -en	the repair	die
Fremdsprache/ -n	the foreign language	die
DDR	GDR (no plural)	die
Pfand/ -e	the collateral (for a loan) mortgage	das
Schneesturm/ -"e	the snowstorm	der
Definition/ -en	the definition	die
Schlafanzug/ -"e	the pajamas	der
Gutschein/ -e	the voucher, coupon, token	der
Serviette/ -n	the napkin	die
Sauna/ -s	the sauna	die
Konsulat/ -e	the consulate	das
Kartoffel/ -n	the potato	die
Treppenhaus/ -"er	the staircase	das
Hochschule/ -n	the college, the university (not C..., not U... )	die
Schnabel/ -"	the mouth (slang) ('S_')	der
Toaster/ -	the toaster	der
Gymnasium/ die Gymnasien	the nine-year school prior to higher education	das
Taschengeld/ -er	the pocket money	das
Vormittag/ -e	the morning ('V_')	der
Überwachung/ -en	surveillance, monitoring, supervision, stakeout ('Ü_)	die
Beerdigung/ -en	the funeral, burial, interment	die
Ablauf/ -"e	the procedure, expiration	der
Quote/ -n	Quote (citation), (price quote), the rate	die
Porträt/ -s	the portrait	das
Bürgersteig/ -e	the pavement, the sidewalk	der
Ehepaar/ -e	the married couple	das
Waage/ -n	the scale, scales (weight)	die
Schlips/ -e	the tie ('S_')	der
Schaffner/ -	the ticket collector (on a train)	der
Lehrling/ -e	the apprentice ('L_')	der
Alltag	the daily routine (no plural)	der
Millimeter	the millimeter (no plural)	der
Kalb/ -"er	the calf (animal)	das
Getue	the fuss, commotion, carrying on about something (no plural) (not 'Aufregung')	das
Bäcker/ -	the baker	der
Kamel/ -e	the camel	das
Faktor/ -en	the factor	der
Säge/ -n	the saw	die
Drucker/ -	the printer	der
Vorgang/ -"e	the process, event, procedure (not 'Verfahren')	der
Landkarte/ -n	the map ('L_')	die
Verlag/ -e	the publisher, Publishing house	der
Diktatur/ -en	the dictatorship	die
Paragraph/ -en/ -en	the paragraph (Absatz, ... )	der
Anfang/ -"e	the beginning ('A_')	der
Versuch/ -e	the attempt	der
Präsident/ -en/ -en	the president	der
Person/ -en	the person (not 'Mensch')	die
Monat/ -e	the month	der
Ukraine	the Ukraine (no plural)	die
Wichtigkeit	the importance (no plural)	die
Abteil/ -e	the compartment, section, cabin (not ...ung)	das
Stammbaum/ -"e	pedigree, bloodline, genealogy, family tree	der
Koffein	the caffeine (no plural)	das
Großeltern	the grandparents (plural only)	die
Disco/ -s	the disco	die
Baustelle/ -n	the site, building site, construction site, jobsite	die
Umfang/ -"e	the extent, scope, range, perimeter, circumference	der
Zwilling/ -e	the twin	der
Viertelstunde/ -n	the quarter hour	die
Wartezeit/ -en	the waiting period	die
Blockade/ -n	the blockade	die
Ausschnitt/ -e	the cleavage (blouse), extract, excerpt, neckline, snippet, section, clipping	der
Bäckerei/ -en	the bakery	die
Staubsauger/ -	the vacuum cleaner	der
Pfanne/ -n	the pan	die
Aufbau/ -ten	the construction	der
Bedrohung/ -en	the threat, menace, intimidation	die
Nichtsnutz/ -e	the good-for-nothing (noun)	der
Tätigkeit/ -en	the activity, occupation, task	die
Buchhandlung/ -en	the bookshop, the bookstore (not Buchladen)	die
Umfrage/ -n	the survey, the poll ('Studie', ... )	die
Lebensstil/ -e	the life style	der
Hundefutter	the dog food (no plural)	das
Elektriker/ -	the electrician (not 'Elektroinstallateur')	der
Lachs/ -e	the salmon	der
Skulptur/ -en	the sculpture	die
Klopapier/ -e	the toilet paper ('K...')	das
Postamt/ -"er	the post office (not "Post")	das
Olive/ -n	the olive	die
Reisende/ -n	the traveler	der
Thermometer/ -	the thermometer	das
Zeitraum/ -"e	the period of time, era, epoch (Epoche, Zeitalter, or ...)	der
Heft/ -e	the notebook, booklet, heft (weight), book, magazine	das
Kommode/ -n	the dresser, the chest of drawers	die
Grieche/ -n	the male Greek person	der
Antike	the antiquity (era), ancient times, ancient world	die
Abgeordnete/ -n	the deputy, representative, delegate	der
Briefträger/ -	the mail carrier	der
Komponist/ -en/ -en	the male composer	der
Urgroßvater/ -"	the great grandfather	der
Acker/ -"	the (arable) field, acre	der
Vorlage/ -n	the template, original, model, presentation	die
Umweltschützer/ -	the environmentalist	der
Teddybär/ -en/ -en	the teddy bear	der
Klassenzimmer/ -	the classroom	das
Schnupfen/ -	the head cold (runny nose)	der
Kraftwerk/ -e	the power station (Elektrizitätswerk, or ...)	das
Rotwein/ -e	the red wine	der
Zensur/ -en	the censorship/ the grade/ the mark (education)	die
Zugabe/ -n	the encore, bonus, addition	die
Regenmantel/ -"	the raincoat	der
Erdgeschoss/ -e	the ground floor	das
Esszimmer/ -	the dining room	das
Arbeitslosigkeit/ -en	the unemployment	die
Bauernhof/ -"e	the farm ('B_')	der
Polizeiwache/ -n	the police station	die
Klumpen/ -	the lump	der
Lagerfeuer/ -	the campfire	das
Zimmermädchen/ -	the maid	das
Schminke/ -n	the cosmetics	die
Gasthaus/ -"er	the Inn, hotel, tavern (Gasthof, or ...)	das
Tomate/ -n	the tomato	die
Krampf/ -"e	the cramp, spasm, convulsion	der
GmbH/ -s	the limited liability company	die
Weihnachtsbaum/ -"e	the Christmas tree	der
Apotheker/ -	the pharmacist, druggist	der
Billard	the billiards (no plural)	das
Campen	the camping (as an activity) (camping, zelten or ...) (no plural)	das
Gleichheit/ -en	the equality (not 'Gleichberechtigung')	die
Ohrfeige/ -n	slap in the face	die
Abitur	the Gymnasium final year exam (no plural)	das
Stichwort/ -"er	the key word	das
Auseinandersetzung/ -en	the argument (not 'St_', 'Ar_')	die
Babysitten	the babysitting (no plural)	das
Toilettenpapier/ -e	the toilet paper ( Klopapier, or ...)	das
Weißwein/ -e	the white wine	der
Rübe/ -n	German colloquial for "head", Turnip, (R...)	die
Einführung/ -en	the introduction (i.e. of a law, a product, a method, etc)	die
Reiseführer/ -	the tour guide, guidebook	der
Statistik/ -en	the statistic	die
Fläche/ -n	the area, surface, expanse, flat	die
Holzfäller/ -	the lumberjack, logger	der
Festplatte/ -n	the hard drive, hard disk	die
Schrecken/ -	the horror, the terror, the shock	die
Dirigent/ -en	conductor, director	der
Handwerker	the craftsperson	der
Sketch/ -e	the sketch	der
Gitarrist (male)/ -en/ -en	the male guitarist	der
Waschbecken/ -	the sink, washbasin ('W_')	das
Schweinestall/ -"e	the pigsty, pigpen, pigstall	der
Kanne/ -n	the pot, (Topf, or ...)	die
Kapitalismus	capitalism (no plural)	der
Windschutzscheibe/ -n	the windshield, windscreen	die
Güter	the commodities, goods (plural only)	die
Epoche/ -n	the era, epoch, age (Zeitraum, Zeitalter, or ...)	die
Mülltonne/ -n	the garbage bin, garbage can ('Mülleimer', 'Abfalleimer', ...)	die
Waisenkind/ -er	the orphan	das
Stereoanlage/ -n	the stereo (system)	die
Turnhalle/ -n	the gymnasium	die
Dialekt/ -e	the dialect	der
Klischee/ -s	the cliché	das
Juwelier/ -e	the jeweler	der
PC/ -s	the PC	der
Franken/ -	the franc (former French currency)	der
Karotte/ -n	the carrot	die
Abteilungsleiter/ -	the manager, department manager, department head ('A_')	der
Lebensjahr/ -e	the year of age, (not 'Lebensalter') ('L_')	das
Cappuccino/ -s	the cappuccino	der
Erzählung/ -en	the story, narrative (Geschichte, Bericht, or ...)	die
Währung/ -en	the currency	die
Buchstabe/ -n	the letter of the alphabet	der
Schauer/ -	the shower (light rain) awe, thrill, shiver, shudder, chill	der
Attraktion/ -en	the attraction (Anziehung, or ...)	die
Geburtsort/ -e	the birthplace	der
Hochhaus/ -"er	the high-rise	das
Schlafsack/ -"e	the sleeping bag	der
Most/ -e	the cider (Austria / South Germany)	der
Bushaltestelle/ -n	the bus stop	die
Wunderkind/ -er	the child prodigy	das
Jockey/ -s	the jockey	der
Geldstrafe/ -n	the fine (Gelbüße or ...'G_')	die
Senior/ -en	the male senior citizen	der
Vorderseite/ -n	the front	die
Fotografie/ -n	the photograph	die
Lilie/ -n	the lily	die
Vitamin/ -e	the vitamin	das
Reisebüro/ -s	the travel agency	das
Essig	the vinegar (no plural)	der
Moderator/ -en	the moderator	der
Halskette/ -n	the necklace	die
Neujahr/ -e	the New Year	das
Ohrring/ -e	the earring	der
Wetterbericht/ -e	the weather forecast	der
Ausdauer	the endurance, stamina, perseverance (no plural)	die
Nachteil/ -e	the disadvantage	der
Expertin/ -nen	the female expert	die
Mithilfe	the assistance ('M_')(no plural)	die
Diplom/ -e	the degree, diploma, certificate	das
Vorstellungsgespräch/ -e	the job interview ('V_')	das
Großstadt/ -"e	Big city, large metropolitan area	die
Athlet/ -en/ -en	the athlete	der
Synagoge/ -n	the synagogue	die
Apfelkuchen/ -	the apple pie	der
Badeanzug/ -"e	the bathing suit	der
Landwirtschaft/ -en	the agriculture, farming	die
Nutzung/ -en	the exploitation, usage, utilization, use (N...)	die
Spielraum/ -"e	the leeway, scope, margin, clearance	der
stags	Tuesdays, on Tuesdays	die
Sonderangebot/ -e	the special sales offer	das
Kassierer/ -	the male cashier	der
Pianist/ -en/ -en	the male pianist	der
Videokamera/ -s	the video camera	die
Armbanduhr/ -en	the wrist watch	die
Kleiderschrank/ -"e	the wardrobe	der
Likör/ -e	the liquor	der
Türke/ -n/ -n	the male Turk	der
Socke/ -n	the sock	die
Giraffe/ -n	the giraffe	die
Besteck	the silverware, cutlery (no plural)	das
Ladenbesitzer/ -	the store owner, shop owner	der
Zwiebel/ -n	the onion	die
Sonnenbrand/ -"e	the sunburn	der
Vorort/ -e	the suburb	der
Aussprache/ -n	the pronunciation, utterance	die
Europäer/ -	the male European	der
Fete/ -n	the party (not Feier) ('F_')	die
Zahnschmerzen	the toothache (plural only)	die
Bahnsteig/ -e	the train station platform	der
Monarchie/ -n	the monarchy	die
Gebühr/ -en	the charge, fee, tax, toll	die
Russin/ -nen	the female Russian person	die
Alpen	the Alps (plural only)	die
Verpackung/ -en	the packaging	die
Rüssel/ -	the trunk (of an elephant)	der
Nationalität/ -en	the nationality	die
Spinat/ -e	the spinach	der
Pferdeschwanz/ -"e	the pony tail, horse's tail	der
Rassismus	the racism (no plural)	der
Rockstar/ -s	the rock star	der
Horrorfilm/ -e	the horror film	der
Quadratmeter/ -	the square meter	der
Laus/ -"e	the louse	die
Papierkorb/ -"e	the wastepaper basket	der
Krankenversicherung/ -en	the health insurance	die
Schulzeit/ -en	the school day, school year	die
Umsatz/ -"e	the turnover, revenue, sales	der
Hymne/ -n	the hymn	die
Olivenöl/ -	the olive oil	das
Vorspeise/ -n	the appetizer, starter	die
Mikroskop/ -e	the microscope	das
Vorwahl/ -en	Code, preselection, preliminary election, area code, dialing code	die
Vorsatz/ -"e	the resolution (new years), purpose, intent, malice, premeditation	der
Abwasch	the kitchen sink, dish washing, washing up, dirty dishes (no plural)	der
Mikrowelle/ -n	the microwave	die
Beschäftigte/ -n	the employee, employed person ('B_')	der
Programmierer/ -	the programmer	der
Marktplatz/ -"e	the market place	der
Brosche/ -n	the brooch	die
Arbeitsamt/ -"er	the employment office, employment agency, job centre	das
Straßenbahn/ -en	the tram, the streetcar	die
Brunch/ -es	the brunch	der
Buche/ -n	the beech tree	die
Kassiererin/ -nen	the female cashier	die
Warze/ -n	the wart	die
Aufforderung/ -en	the invitation, request, challenge	die
Fahrerin/ -nen	the female driver	die
Sauerkraut	the sauerkraut (no plural)	das
Abschleppwagen/ -	the tow truck	der
Wortschatz/ -"e	the vocabulary ('W_')	der
Gebildete/ -n	the educated person	der
Rückenschmerzen	the backache (plural only)	die
Integration/ -en	the integration	die
Rhein	the Rhine (no plural)	der
Lira/ die Lire	the lira (former Italian currency)	die
Schulabschluss/ -"e	graduation, high school diploma	der
Fotoapparat/ -e	the camera ('F_')	der
Bettwäsche	the bedlinen (no plural)	die
Zimt	the cinnamon (no plural)	der
Spalt/ -e	the gap, fissure, slit, crack	der
Druckerei/ -en	the print shop	die
Fleischer/ -	the butcher ('F_')	der
BRD	the FRG, Federal Republic of Germany	die
Tenor/ -"e	the thrust (theme, content, topic, purpose) tenor	der
Knopf/ -"e	the button, knob	der
Automat/ -en/ -en	the vending machine	der
Wasserhahn/ -"e	the water faucet, faucet, the tap	der
Stadtzentrum/ die Stadtzentren	the city or town center	das
Spalte/ -n	column (page, chart), slot, crevice, fissure, cleft, crack	die
Gasthof/ -"e	the inn, hotel (Gasthaus, or ...)	der
Untertasse/ -n	the saucer	die
Bewerbungsgespräch/ -e	the job interview ('B_')	das
Referat/ -e	the presentation, lecture, report, department	das
Anmeldung/ -en	the application, registration, enrollment, login	die
Tastatur/ -en	the computer keyboard	die
Schornstein/ -e	the chimney, smokestack	der
Strumpf/ -"e	the stocking	der
Weltmeisterschaft/ -en	The world Championship, World Cup	die
Erkrankung/ -en	the illness (Krankheit, or ...)	die
Strumpfhose/ -n	the tights, pantyhose	die
Beauftragter/ die Beauftragten	the (male) appointee, designee, advocate, representative, agent (B_)	der
Sommerferien	the summer vacation (plural only)	die
Kontext/ -e	the context	der
Trikot/ -s	the jersey	das
Eishockey	the ice hockey (no plural)	das
Zusatz/ -"e	the addendum, augmentation, supplement, addition	der
Sicherheitsgurt/ -e	the seatbelt, safety belt, safety harness	der
Käsekuchen/ -	the cheesecake	der
Pfote/ -n	the paw	die
Allee/ -n	the alley, the avenue	die
Holocaust	the holocaust (no plural)	der
Parkett/ -e	the parquet flooring (no plural): a type of cross-woodboard pattern	das
Sozialhilfe	the welfare, social assistance (no plural)	die
Müsli	the muesli (cold, whole grain cereal with nuts and fruit, usually served with milk) (no plural)	das
Tapete/ -n	the wallpaper	die
Schwierigkeit/ -en	the difficulty	die
Seifenoper/ -n	the soap opera	die
Betreuung	the care, support (customer support), maintenance (no plural)	die
Hecke/ -n	the hedge, hedgerow	die
Makkaroni	the macaroni (plural only)	die
Schlosser/ -	the locksmith, metalworker, toolmaker	der
Terminkalender/ -	the diary, appointment book, appointment schedule	der
Friseuse/ -n	the female hairdresser (outdated, or often used pejoratively)	die
Förderung/ -en	the support, promotion, sponsorship, encouragement,	die
Namensschild/ -er	the name plate, name tag	das
Nudel/ -n	the noodle	die
Treibhauseffekt/ -e	the greenhouse effect	der
Muttersprache/ -n	the mother tongue	die
Kilogramm/ -	the kilogram	das
Koalition/ -en	the coalition	die
Annäherung/ -en	the approach, approximation, drawing near, convergence	die
Popmusik/ -en	the pop music	die
Schlager/ -	the hit, hit song, pop song	der
Vorschau/ -en	the preview, teaser (promo)	die
Bohne/ -n	the bean	die
Jahrzehnt/ -e	the decade	das
Harfe/ -n	the harp	die
Hauptschule/ -n	the general seconary school ('H_')	die
Hamster/ -	the hamster	der
Sterblichkeit/ -en	the mortality/ the mortality rate	die
Stadtteil/ -e	the district, the part of the city	der
Pfosten/ -	the post (as in wooden post, etc.) pole, stake	der
Enzyklopädie/ -n	the encyclopedia (E-)	die
Broschüre/ -n	the brochure, leaflet, pamphlet, booklet ('Prospekt' or ...)	die
Italienerin/ -nen	the Italian female	die
Brokkoli	the broccoli (no plural)	der
Torwart/ -e	the goalkeeper	der
Schlaftablette/ -n	the sleeping pill (not 'Schlafmittel')	die
Konditorei/ -en	the confectionary, pastry shop, cake shop	die
Schuldschein/ -e	the IOU (I owe you)	der
Bankdirektor/ -en	the bank manager	der
Teig/ -e	the dough, pastry, batter (for pancakes, waffles, etc. )	der
Einzelkind/ -er	the only child	das
Angler/ -	the Angler, fisherman, fisher	der
Schlüsselbund/ -"e	the keyring, set of keys, bunch of keys	der
Sünde/ -n	sin, transgression	die
Nachttisch/ -e	the nightstand, night table	der
Krimi/ -s	the crime film/novel/story	der
Auswirkung/ -en	the impact, ramification, repercussion, effect, consequence ('A_')	die
Bizeps/ -e	the biceps	der
Metzgerei/ -en	the butcher shop, meat market ('M_')	die
Pflaume/ -n	the plum	die
Motorboot/ -e	the motorboat	das
Arbeiterklasse	the working class (no plural)	die
Altstadt/ -"e	the old downtown, historic downtown, old city center, historic district	die
Gebrauchsanweisung/ -en	the operator's manual, operating manual, operating instructions, directions, signature on prescriptions	die
Fahrplan/ -"e	The timetable, schedule (train, bus, etc.), road map	der
Dokumentarfilm/ -e	the documentary film	der
Projektor/ -en	the projector	der
Startseite	the homepage, front page	die
Tunnel/ -	the tunnel	der
Merkmal/ -e	the feature, trait, characteristic, attribute ('M_')	das
Gulden/ -	the guilder (former Dutch currency)	der
Drogerie/ -n	the drugstore, (Apotheke, or ...)	die
Tabelle/ -n	the spreadsheet, chart, table, schedule	die
Weltreise/ -n	the world tour, world cruise, trip around the world	die
Misserfolg/ -e	failure, fiasco, flop ('M_'	der
Wiedervereinigung	the reunification, reintegration, reunion, (German) reunification, reunification of Europe (no plural)	die
Bundesregierung/ -en	the federal government	die
Sonnencreme/ -s	the suntan lotion	die
Schaukelstuhl/ -"e	the rocking chair	der
Kaffeemaschine/ -n	the coffee machine, coffee maker	die
Kunstgalerie/ -n	the art gallery ('K_')	die
Rückspiegel/ -	the rear-view mirror	der
Bußgeld/ -er	the fine, penalty ('B_')	das
Rolltreppe/ -n	the escalator, moving stairs	die
Taschenmesser/ -	the pocket knife, penknife	das
wolf/ -"e	the wolf	der
Backofen/ -"	the baking oven	der
wüste/ -n	the desert, wasteland, wilderness	die
Maurer/ -	the mason, bricklayer (Steinmetz, or ...)	der
rtig	such, of this/that kind, of this/that sort, of this/that type (derart, or ...)	der
Talkshow/ -s	the talk show	die
Umleitung/ -en	the detour, diversion, redirection, rerouting	die
Ikone/ -n	the icon	die
Einkaufsliste/ -n	the purchase list, shopping list, grocery list	die
Entwickler/ -	developer, designer	der
Rundfunk	the broadcast, broadcasting, radio (no plural) ('R_')	der
Cheddar	the cheddar (cheese) (no plural)	der
Empfangsdame/ -n	the female receptionist	die
Sardine/ -n	the sardine	die
Konsequenz/ -en	the consequence ('Folge' or ...)	die
Rückfahrt/ -en	the return trip	die
Meerschweinchen/ -	the guinea pig	das
Wochentag/ -e	the weekday, day of the week	der
Taschenrechner/ -	the calculator, pocket calculator, calculators	der
Krippe/ -n	manger (biblical), the crib (baby bed) children's daycare center	die
Hagel	the hail, volley (of gunfire) (no plural)	der
Anforderung/ -en	the demand, requirement, request (A_)	die
Ausweg/ -e	the way out, escape, resort, outlet	der
Ausfall/ -"e	outage, failure, breakdown, absence ('A_')	der
Einbahnstraße/ -n	the one way street	die
Kiosk/ -e	the kiosk	der
Redefreiheit	freedom of speech (no plural)	die
Dosenöffner/ -	the can opener	der
Postleitzahl/ -en	the postal code	die
Luftdruck/ -"e	the air pressure, atmospheric pressure, barometric pressure, tire pressure (am)	der
Klebstoff/ -e	the glue, adhesive, paste (not 'Kleber,' 'Leim'	der
Abfalleimer/ -	the rubbish bin, garbage can ('Mülltonne', 'Mülleimer', ...)	der
Grafik/ -en	the chart, diagram, graphic ('Schaubild' or ...)	die
Modenschau/ -en	the fashion show	die
Verschmutzung/ -en	the pollution, contamination	die
Briefmarke/ -n	the postage stamp	die
Heimfahrt/ -en	the drive home, journey home	die
Schlussverkauf/ -"e	the sale, clearance sale, end of season sale, closing out sale	der
Sweatshirt/ -s	the sweatshirt	das
Flugnummer/ -n	the flight number	die
Gleichberechtigung	the equality, equal rights, equal status (no plural) ('G_')	die
Idealismus	the idealism (no plural)	der
Auszug/ -"e	the extract, excerpt, statement (of account), digest	der
Harz	the Harz Mountains (no plural)	der
Stundenplan/ -"e	the schedule (edu), class schedule, time table (Br)	der
Ode/ -n	the ode	die
Sozialamt/ -"er	the social security department, social services department,	das
Einnahme/ -n	the revenue, income, intake	die
Erfrischungen	the refreshments (plural only)	die
Reiseziel/ -e	the travel destination	das
Synonym/ -e	the synonym	das
Turnen	the gymnastics (no plural)	das
Fußgänger/ -	the pedestrian, pedestrians, walker, walkers	der
Hausnummer/ -n	the house number	die
Leitungswasser	the faucet water, water from the faucet, tap water, piped water (no plural)	das
Pappe/ -n	the cardboard, pasteboard, carton, driver's license	die
Sitzplatz/ -"e	the seat, seating position	der
Doppelbett/ -en	the double bed	das
Büstenhalter/ -	the bra, brassiere	der
Tischtuch/ -"er	the tablecloth	das
Untergrund/ -"e	the underground (all senses), subsoil, subfloor	der
Ferienhaus/ -"er	the vacation home, summer cottage	das
Waschsalon/ -s	the laundromat	der
Fernsehprogramm/ -e	the Television Program, TV show (not 'S...')	das
Hausarzt/ -"e	the male family doctor, general practitioner	der
Kognak	the cognac (no plural)	der
Fingernagel/ -"	the fingernail	der
Aktienmarkt/ -"e	the stock market ('A-')	der
Kaffeekanne/ -n	the coffee pot	die
eintrag/ -"e	the entry, record, item, input	der
Sinfonie/ -n	the symphony	die
Import/ -e	the import (Einfuhr, Bedeutung, or ...)	der
Genetik/ -	the genetics (no plural)	die
Warteraum/ -"e	the waiting room	der
Möbelstück/ -e	the piece of furniture	das
Weinberg/ -e	the vineyard	der
Freundeskreis/ -e	the circle of friends	der
Teelöffel/ -	the teaspoon	der
Anwendung/ -en	the application, use, implementation ('A_')	die
Dienstleistung/ -en	the service, services	die
Muttertag/ -e	the Mother's Day	der
Niederschlag/ -"e	the precipitation, rainfall, downpour	der
Schwarzwald	the Black Forest (no plural)	der
Einkaufswagen	the shopping cart	der
Radfahren	the cycling, bicycling (no plural)	das
Deckung/ -en	the cover, coverage (ins, fin) cover (protective)	die
Vatertag/ -e	the Father's Day	der
Kleidungsstück/ -e	the article of clothing	das
Geldschein/ -e	the banknote ('G_')	der
Zeh/ -en	the toe	der
Föhn/ -e	the blow dryer	der
Lebensmittelgeschäft/ -e	the grocery store (Lebensmittelmarkt, or... 'L_')	das
Bundeskanzler/ -	the Federal Chancellor	der
Thermosflasche/ -n	the thermos	die
Eisbahn/ -en	the ice rink	die
Schwerpunkt/ -e	the emphasis, focus	der
Wohnort/ -e	the place of residence	der
Wettlauf/ -"e	the foot race, race (also fig)	der
Lampenfieber/ -	the stage fright	das
Tennisplatz/ -"e	the tennis court	der
Einwanderung/ -en	the immigration (E~)	die
Geburtstagskarte/ -n	the birthday card	die
Personalausweis/ -e	the ID card, identification card	der
Bügeleisen/ -	the iron (for clothes)	das
Erste Weltkrieg	First World War	der
Türkin/ -nen	the female Turk	die
Wohnhaus/ -"er	the residential building	das
Kochbuch/ -"er	the cookbook	das
Tourismus	tourism (no plural)	der
Herzschlag/ -"e	the heartbeat, heartthrob	der
Keyboard/ -s	the musical keyboard	das
Nordsee	the North Sea (no plural)	die
Liebhaber/ -	the fan, lover, admirer, enthusiast, aficionado	der
Pressefreiheit	the freedom of the press (no plural)	die
Prospekt/ -e	the brochure, leaflet, backdrop, catalogue	der
Raststätte/ -n	the rest area (on a motorway)/ the roadhouse	die
Barometer/ -	the barometer	das
Kunststoff/ -e	the plastic, plastics, synthetic, synthetic material	der
Oberschicht/ -en	the upper class, elite, top layer	die
Kochin/ -nen	the female cook	die
Klavierkonzert/ -e	the piano concerto	das
Aula/ -s	the school auditorium, the assembly hall, main lecture hall	die
Hauptgericht/ -e	the entrée, main dish, main course	das
Wohnblock/ -"e	the apartment building, block of flats, block of houses (W_)	der
Scheckheft/ -e	the checkbook ('Scheckbuch' or ...)	das
Kontaktlinse/ -n	the contact lense	die
Datenbank/ -en	the database, databank	die
Volksmusik/ -en	the folk music	die
Mietshaus/ -"er	the tenant-occupied building, apartment building, rental building (M_)	das
Automechaniker/ -	the car mechanic	der
Sparkasse/ -n	the savings bank	die
Aktiengesellschaft/ -en	the corporation (A_)	die
Bücherregal/ -e	the bookcase	das
Botanik	the botany (no plural)	die
Gemüsehändler/ -	the vegetable dealer, vegetable market	der
Relativitätstheorie	the theory of relativity (no plural)	die
Verhütung/ -en	the contraception (V_)	die
Waschpulver/ -	the laundry detergent powder	das
Gasherd/ -e	the gas stove/ the gas cooktop	der
Ausrüstung/ -en	equipment, apparatus, gear	die
Rundfahrt/ -en	the round trip	die
Gaststätte/ -n	the cheap restaurant ('G_')	die
Furche/ -n	the furrow	die
Plakatwand/ -"e	billboard, hoarding, advertisement board	die
Ministerpräsident/ -en/ -en	the prime minister	der
Skilaufen	the skiing (as an activity) (no plural) ('Skifahren" or ...)	das
Pianistin/ -nen	the female pianist	die
Hausaufgabe/ -n	the homework assignment	die
Rechtskurve/ -n	the right-hand curve/bend, curve/bend to the right, sharp deviation to the right	die
Wegfall/ -	the elimination, omission, discontinuation, cessation	der
Geographie	the geography (no plural) ('Erdkunde' or ...)	die
Komposition/ -en	the composition	die
Igel/ -	the hedgehog	der
Schimpfwort/ -"er	the cuss word, expletive, profane word, profanity	das
Klarinette/ -n	the clarinet	die
Büfett/ -s	the buffet	das
Akzeptanz	the acceptance, acceptability (no plural)	die
Hauptbahnhof/ -"e	the main railroad station, main railway station	der
Lehrplan/ -"e	the curriculum, syllabus, lesson plan	der
Audi/ -s	the Audi (german automobile manufacturer)	der
Verkehrsmittel/ -	the means of transportation	das
Halsschmerzen	the sore throat (plural only)	die
Ansichtskarte/ -n	the picture postcard, postcard	die
Zebrastreifen/ -	the crosswalk ('Z_')	der
Festtag/ -e	the public holiday ('Feiertag' or ...)	der
Personalchef/ -s	the personnel manager	der
Briefumschlag/ -"e	the envelope ('Umschlag' or ...)	der
Logistik/ -	the logistics, planning and exectution	die
Touristenattraktion/ -en	the tourist attraction	die
Moskito/ -s	the mosquito (Mücke, or ...)	der
Rowdy/ -s	the thug, hooligan	der
Ruhm	fame, glory, renown	der
Rasierer/ -	the razor, the shaver	der
Steuerrad/ -"er	the steering wheel ('S_')	das
Farbfernseher/ -	the Color TV	der
Mozzarella/ -s	the mozzarella	der
Wellensittich/ -e	the parakeet, budgie	der
Chronik/ -en	the chronicle, history, timeline	die
Tulpe/ -n	the tulip	die
Etui/ -s	the case (small box, holder, receptacle), pencil case	das
Diele/ -n	the hallway, plank, floorboard.	die
Fremdenführer/ -	the tour guide ('F'_)	der
Tausendfüßler/ -	the millipede, thousand legger (us. col)	der
Fassung/ -en	the composure, socket (lightbulb socket), version, frame, edition	die
Kork/ -e	the cork	der
Anzeichen/ -	evidence, indication, (early) sign, symptom (medical)	das
Walkman/ die Walkmen	the walkman	der
Aufheiterung/ -en	the brighter period, clearing up	die
Sitzung/ -en	the session, meeting, conference, sitting	die
Sparkonto/ -s	the savings account	das
Staatskasse/ -n	the state treasury, government koffer	die
Taschenbuch/ -"er	the paperback	das
Stadtplan/ -"e	the map of the city or town	der
Richtigkeit/ -en	the correctness	die
Draht/ "-e	the wire, filament	der
Kinderlähmung	the polio (no plural)	die
Mehrzahl	the majority (no plural) ('Mehrheit,' Großteil' or ... 'M'_)	die
Spülbecken/ -	the sink (Waschbecken, Spüle, or ...)	das
Schopf/ -"e	the tuft of hair, schock of hair	der
Musikerin/ -nen	the female musician	die
Computerspiel/ -e	the computer game	das
Bildhauerei/ -en	the art of sculpting	die
Griff/ -e	the grasp, handle, grip ('G_')	der
Blindenhund/ -e	the guide dog	der
Vorfahr/ -en/ -en	the ancestor, forefather (' Vorgänger,' or 'V_')	der
Mandarine/ -n	the mandarin orange	die
Kinderabteilung/ -en	the children's department	die
Privatschule/ -n	the private school	die
Zoologie	the zoology (no plural)	die
Bahnübergang/ -"e	the railroad crossing	der
Stand/ - "e	the position, standing, stand, state, status, condition	der
Zwischenprüfung/ -en	the exam after two years of college	die
Gourmet/ -s	the gourmet	der
Fahrgeld/ -er	the fare (bus, car, etc.)	das
Mitgliedschaft/ -en	the membership (not 'zugehörigkeit')	die
Telefongespräch/ -e	the telephone conversation	das
Utopie/ -n	the utopia	die
Schuhmacher/ -	the shoemaker	der
Niederlande	the Netherlands (plural only)	die
Kriterium/ die Kriterien	the criterion	das
Slowakei	the Slovakia (no plural)	die
Hausmann/ -"er	the househusband	der
Heizkörper/ -	the radiator, heater, heating element, heating apparatus	der
Notfall/ -"e	the emergency, case of emergency	der
Urgroßmutter/ -"	the great grandmother	die
Schulbeginn	the beginning of school (no plural)	der
Wintermantel/ -"	the winter coat	der
Reifenpanne/ -n	the flat, flat tire, blowout	die
Einkaufstasche/ -n	the shopping bag	die
Bierbauch/ -"e	the beer belly	der
Tennisschläger/ -	the tennis racket	der
Tiefkühltruhe/ -n	the freezer	die
Präzisionsinstrument/ -e	the precision instrument	das
Mikrobiologie	the microbiology (no plural)	die
Rotkohl	the red cabbage (no plural)	der
Nomen/ -	the noun ('N_')	das
Privathaus/ -"er	the private home	das
Überschrift/ en	the heading, caption, headline, title	die
Pendler/ -	the commuter	der
Kopfsalat/ -e	the head of lettuce	der
Morgentoilette/ -n	the morning rituals	die
Gardine/ -n	the curtain, drape, net curtain ('Vorhang' or ...)	die
Karikatur/ -en	the caricature	die
Glatteis	the sheet of ice, black ice, smooth black hair (no plural)	das
Süßigkeit/ -en	the candy, treat, sweet, sweetness	die
Schlafraum/ -"e	the bedroom, dormitory room ('schlafzimmer' or ...)	der
Naturwissenschaft/ -en	the natural science ('Naturforschung' or ...)	die
Wintergarten/ -"	the conservatory, solarium, sunroom, winter garden	der
Videorecorder/ -	the video recorder	der
Vorfahrt/ -en	the priority, the right of way (traffic)	die
Berufsberatung/ -en	the career counseling, vocational counseling, career advice	die
Tomatensoße	the tomato sauce (no plural)	die
Innovation/ -en	the innovation ('I_')	die
Sciencefiction	the science fiction (no plural)	die
Dauerwelle/ -n	the perm, permanent (hair)	die
Ostsee	the Baltic Sea (no plural)	die
Kochkurs/ -e	the cooking class, cooking course	der
Berufsschule/ -n	the vocational school	die
Beschränkung/ -en	the constraint, restriction, restraint, limitation	die
Menschenrecht/ -e	the human right	das
Radfahrer/ -	the cyclist	der
Banknote/ -n	the banknote ('B_')	die
Anrichte/ -n	the sideboard, dresser, pantry	die
Grundgesetz/ -e	the constitution, the basic law (not 'Verfassung')	das
Blumenhändler/ -	the male florist	der
Gärtnerin/ -nen	the female gardener	die
Anbieter/ -	the vendor, provider, supplier	der
Friseurin/ -nen	the female hair stylist	die
Nähmaschine/ -n	the sewing machine	die
Vorstand/ -"e	the board (administration), chairman, dean, director	der
Brieffreund/ -e	the (male) pen pal	der
Backstein/ -e	the brick ('Ziegelstein', 'Ziegel', or ...)	der
Einbrecherin/ -nen	the female burglar	die
Kritikerin/ -nen	the female critic	die
Substantiv/ -e	the noun ('S_')	das
Reisebegleiter/ -	the traveling companion, chaperon	der
Oktoberfest/ -	the Octoberfest	das
Arbeitnehmer/ -	the employee ('A_')	der
Sandale/ -n	the sandals	die
Notebook/ -s	the notebook (computer)	das
Reisebus/ -se	the tour bus	der
Gastronomie	the catering (no plural), gastronomy, food service industry	die
Pfingsten/ -	the Pentecost	das
Haarbürste/ -n	the hairbrush	die
Kännchen/ -	the small jug, small can, small pot	das
Grenzübergang/ -"e	the border crossing, checkpoint	der
Eselsbrücke/ -n	the mnemonic device	die
Turnschuh/ -e	the gym shoe, the sneaker	der
Buchenwald/ -"er	the beech forest	der
Fußweg/ -e	the sidewalk, footpath, walkway, pathway	der
Entwicklung/ -en	the development, progress, evolution (development)	die
Neuerung/ -en	the innovation, improvement, reform ('N_')	die
Arbeitsraum/ -"e	the study ('Arbeitszimmer' or ...)	der
Zeichentrickfilm/ -e	the cartoon	der
Spülmittel/ -	the dishwashing liquid	das
Informatiker/ -	the computer scientist	der
Stofftier/ -e	the stuffed animal	das
Modegeschäft/ -e	the fashion store (M~)	das
Geschwindigkeitsbegrenzung/ - en	the speed limit	die
Luftschutzkeller/ -	the air-raid shelter	der
Auswanderer/ -	the emigrant ('A_')	der
Eisenbahnlinie/ -n	the rail line, railroad line, railway line ('E~')	die
Griechin/ -nen	the female Greek person	die
Weinglas/ -"er	the wine glass	das
Mitbringsel/ -	the small gift (brought to give to a host)	das
Waschküche/ -n	the laundry room ('Wa_')	die
Auszubildende/ -n	the apprentice, trainee ('A_')	der
Tatort/ -e	scene of the crime, crime scene, place where event occurs	der
Rentenversicherung/ -en	the pension insurance, pension insurance fund	die
Präsens/ die Präsentia	the present tense	das
Teppichboden/ -"	the carpeted floor	der
Haarsträhne/ -n	the strand of hair	die
Kuckucksuhr/ -en	the cuckoo clock	die
Ferienzeit/ -en	the holiday season, holiday period, vacation time	die
Ferienjob/ -s	the summer job/ the vacation job	der
Tagesmenü/ -s	the menu of the day	das
Konzertsaal/ die Konzertsäle	the concert hall	der
Zweisitzer/ -	the two-seater	der
Erschöpfung/ -en	depletion, exhaustion, fatigue	die
Universitätsabschluss/ -"e	the university degree ('U_')	der
Hörsaal/ die Hörsäle	the lecture hall	der
Arbeitskollege/ -n/ -n	the colleague from work	der
Erzählerin/ -nen	the female narrator	die
Erdkunde	the geography (no plural), ('Geographie' or ...)	die
Hundehaufen/ -	the dog feces, dog crap, dog turd, dog pile	der
Alltagsleben/ -	the everyday life	das
Sandburg/ -en	the sandcastle	die
Schnellimbiss/ -e	the snack bar, fast food restaurant	der
Maßnahme/ -n	the measure (means, method), sanction, scheme	die
Spülmaschine/ -n	the dishwasher ('S_')	die
Ungleichheit/ -en	the inequality ('U_')	die
Immigrant/ -en/ -en	the immigrant ('I_')	der
Verwandtschaft/ -en	the relatives, relationship, kinship, affiliation	die
Weihnachtsferien	the Christmas vacation (plural only)	die
Jugendherberge/ -n	the youth hostel	die
Kommilitone/ -n/ -n	the classmate (in College or University) ('K_')	der
Döner/ -	the kebab	der
Schaufensterbummel/ -	the window-shopping/ the window-shopping expedition	der
Tagesschau/ -en	A very popular German Television News Program ('T_')	die
Rechtsanwältin/ -nen	the female lawyer	die
Teekessel/ -	the tea kettle	der
Schuhgeschäft/ -e	the shoe store ('Schuhladen" or ...)	das
Voraussetzung/ -en	the condition, precondition (to an agreement), requirement, prerequisite ('V_')	die
Filzstift/ -e	the felt tip pen	der
Weihnachtsfeiertag/ -e	the Christmas Day ('Weihnachten,' Weihnachtstag' or ...)	der
Dampflokomotive/ -n	the steam locomotive	die
Pflichtfach/ -"er	the required subject, compulsory subject	das
Schwarzbrot/ -e	the rye bread	das
Regenwetter	the rainy weather (no plural)	das
Mittelstand/ -"e	the middle class, small to mid-size business	der
Komponistin/ -nen	the female composer	die
Hockeyschläger/ -	the hockey stick	der
Akku/ -s	battery (not B_)	die
Gastarbeiter/ -	the guest worker, foreign worker	der
Bundesrepublik	the Federal Republic (no plural)	die
Anklage/ -n	the accusation, charge, prosecution, indictment ('A_')	die
Hundewetter	the rotten weather ('H_') (no plural)	das
Ornament/ -e	the ornament	das
Einzelbett/ -en	the single bed	das
Ewigkeit	the eternity, perpetuity, immortality	die
Traumberuf/ -e	the dream job, job of one's dreams	der
Semesterferien	the semester break (plural only)	die
Leidenschaft/ -en	the passion, fervor, zeal	die
Couchtisch/ -e	the coffee table	der
Kassenzettel/ -	the sales receipt, sales slip (not 'Verkaufsbeleg')	der
Champignon/ -s	the mushroom	der
Feinkostgeschäft/ -e	the delicatessen, deli	das
Personenwagen/ -	the passenger car (automotive / rail)	der
Abbildung/ -en	the illustration, picture, image, figure ('A_')	die
Emigrant/ -en/ -en	the emigrant ('E_')	der
Fabel/ -n	the fable	die
Schulzeugnis/ -se	the school report card, school grades card ('S_')	das
Mikrowellenherd/ -e	the microwave oven	der
Privileg/ -ien	the privilege, prerogative	das
Klassenarbeit/ -en	the classwork	die
Fensterladen/ -"	the window shutter	der
Schaubild/ -er	the chart, schematic, diagram, graph	das
Klapptisch/ -e	the folding table	der
vorgehensweise/ -n	the approach, procedure, strategy, tactic, method (of dealing with sth)	die
Umland	the surrounding region, surrounding land (no plural)	das
Damenabteilung/ -en	the women's department	die
Informatik	the Computer Science, IT (Information Technology	die
Puls/ -e	the pulse, pulse rate, heart rate	der
Kreisverkehr/ -e	the traffic circle/ the roundabout	der
Etagenbett/ -en	the bunk bed	das
Ohrenschmerzen	the earache (plural only)	die
Rechner	computer, calculator, computers	der
Bruttosozialprodukt/ -e	the Gross National Product	das
Geldtasche/ -n	the wallet ('G_')	die
Ingenieurin/ -nen	the female engineer	die
Buslinie/ -n	the bus line	die
Gerücht/ -e	rumor, hearsay	das
Seniorin/ -nen	the female senior citizen	die
Staatschef/ -s	the head of state	der
Junkfood/ -s	the junk food	das
Azubi/ -s	the apprentice, trainee (abbreviation of Auszubildende)	der
Platzkarte/ -n	the reservation ticket (for a seat), reservation card	die
Sauwetter	the rotten weather ('S_') (no plural)	das
Gesamtbevölkerung/ -en	the total population	die
Europäerin/ -nen	the female European	die
Kocherei	the cooking (no plural)	die
Erziehungsurlaub/ -e	the pregnancy leave, childcare leave	der
Beobachtung/ -en	the observation, monitoring, surveillance ('not Bet_')	die
Bundesministerium/ die Bundesministerien	the federal ministry	das
Hauptberuf/ -e	the day job, one's regular job	der
Hochschulabschluss/ -"e	the university degree ('H_')	der
Partnerstadt/ -"e	the twin city, sister city	die
Farbfoto/ -s	the color photo	das
Hauptsache/ -n	the main thing, the most important thing	die
schlacht/ -en	battle, slaughter (of people), combat	die
Deutschstunde/ -n	the German lesson	die
Sommerschlussverkauf/ -"e	the summer closeout sale, summer clearance sale	der
Nachttischlampe/ -n	the bedside lamp	die
Wetterkarte/ -n	the weather map	die
Verkehrszeichen/ -	the traffic sign, street sign, road sign	das
Zahnklinik/ -en	the dental clinic	die
Elektroherd/ -e	the electric stove	der
reichweite/ -n	the range, reach, scope, coverage	die
Sauerbraten/ -	the marinated roast beef	der
Beistelltisch/ -e	the end table	der
Bundestag	the German parliament (no plural)	der
Weinkenner/ -	the wine connoisseur	der
Esslöffel/ -	the tablespoon	der
Rückkehr/ -	the return, recurrence, comeback	die
flüchtling/ -e	the refugee, fugitive	der
Anfrage/ -n	the inquiry, question, query	die
Ossi/ -s	the East German	der
Wessi/ -s	the West German	der
Blumenhändlerin/ -nen	the female florist	die
Fußgängerüberweg/ -e	the pedestrian bridge, pedstrian crossing ('F_')	der
Querflöte/ -n	the transverse flute	die
Sportprogramm/ -e	the sports program	das
Fleischerei/ -en	the butcher shop, meat market ('F_')	die
Kleidergeschäft/ -e	the clothing store (K~)	das
Blockflöte/ -n	the recorder (musical instrument)	die
Delikatessengeschäft/ -e	the delicatessen	das
Festung/ -en	the fortress, stronghold, fort	die
Fotogeschäft/ -e	the photo store	das
Bauchschmerzen	stomachache (plural)	die
Spielwarengeschäft/ -e	the toy store	das
Ortsname/ -ns/ -n	the place name	der
Dreiergruppe/ -n	the threesome, triad, trio, group of three	die
Peseta/ die Peseten	the peseta (former Spanish currency)	die
Residenz/ -en	the residence	die
Winterschlussverkauf/ -"e	the winter sale, winter closeout sale	der
Softeis	the soft ice cream (no plural)	das
Brauerei/ en	the brewery, beer plant, beer company	die
Eigentum/ -	the property, possession, ownership, properties	das
Glückwunschkarte/ -n	the greeting card (christmas card, birthday card, etc.)	die
Herrenabteilung/ -en	the men's department	die
Sportabteilung/ -en	the sporting goods department	die
Autobahnkreuz/ -e	the highway intersection	das
Informationszeitalter	the Information Age (no plural)	das
Studienrichtung/ en	the field of study	die
Heimtrainer/ -	the exercise machine, home gym	der
Kulturschock	the culture shock (no plural)	der
Blumengeschäft/ -e	the flower shop ('Blumenladen' or...)	das
Goldschmied/ -e	the goldsmith	der
Tennisschuh/ -e	the tennis shoe	der
Überlegung/ -en	the consideration, deliberation, reflection, pondering, thought	die
Wochenzeitung/ -en	the weekly newspaper	die
klassische Musik/ -en	the classical music	die
Stab/ -"e	the staff, rod, bar, stick, wand	der
Übertragung/ -en	the transfer, transmission, delivery, broadcast, broadcasting	die
Klappstuhl/ -"e	the folding chair	der
Qual/ -en	torture, agony, anguish	die
Stoffbär/ -en/ -en	the stuffed toy bear	der
Schrebergarten/ -"	the garden plot	der
Superlativ/ -e	the superlativ	der
Baustil/ -e	the building style	der
Wahnsinn/ -	madness, insanity (not 'Irrsinn')	der
Theaterkarte/ -n	the theatre ticket	die
Können/ -	the prowess, ability, skills, expertise ('K_')	das
Blitz	the lightning	der
Wohnungsbau/ -	the housing construction, residential construction, appartment construction	der
Hausschuh/ -e	the house shoe, bedroom slipper, slipper	der
Rockgruppe/ -n	the rock group	die
Gießkanne/ -n	the watering can	die
Familienname/ -ns/ -n	the surname, last name, family name	der
Wohnraum	living space, living room, living area	der
Geschwister	the sibling(s) (on official documents)	das
Hecke schneiden	to clip/cut the hedge(s)	die
Öl/ -e	the oil	das
Klimawandel	climate change	der
Mittelklassewagen/ -	the mid-sized car	der
Unternehmen/ -	company, enterprise, corporation, business, firm	das
Schädel	skull, cranium	der
Parfüm/ -e	the perfume	das
Toner	the toner (laser printer)	der
Rheintal	the Rhine valley (no plural)	das
letzte Mal	the last time (no plural)	das
Individualist/ -en/ -en	the individualist	der
Härte/ -en	hardship, severity, harshness, rigidity, toughness	die
Dienst	Short for Tuesday (Tue.) service, duty	der
Stoppel	the stubble (no plural)	die
Bürohilfe	the office help (no plural)	die
Beisel/ -n	the pub (Austrian term)	das
Datenschutz/ -	the data protection, data privacy	der
Unternehmer/ -	the entrepreneur, businessman, contractor	der
EDV-Kenntnisse	the computer experience, computer skills	die
ist echt toll.	That is really fantastic/awesome, great	Das
Südpol	the South Pole (no plural)	der
Empfehlung/ -en	the recommendation, advice, reference	die
Ruf/ -e	the reputation, call (from the distance), standing (reputation)	der
Lieferwagen/ -	the delivery van	der
Kompromiss/ -e	the compromise, tradeoff	der
Weißwurst/ -"e	the veal sausage	die
Südseeinsel/ -n	the South Sea island	die
Faschingsdienstag/ -e	the Shrove Tuesday, Mardi Gras (term used in southern Germany and Austria)	der
Tafel/ -n	the board, blackboard, plaque (awards), panel, slab	die
freie Marktwirtschaft	free enterprise	die
Zimmerpflanze/ -n	the houseplant	die
Ostermontag/ -e	the Easter Monday	der
Übergang/ -"e	the transition, segue (music), junction, crossover, crossing	der
Hai/ -e	the shark	der
Treffer/ -	the strike, hit, goal (sports)	der
Ansatz/ -"e	the approach (to a problem), concept, attempt, start	der
Tipp/ -s	hint, tip, clue, pointer (T_)	der
Verhalten/ -	the behavior, conduct, demeanor	das
Gemeinsamkeit/ -en	the commonality, common feature, common ground ('G_')	die
Platzreservierung/ -en	the seat reservation	die
Hinfahrt/ -en	the journey there, the trip toward a specific destination	die
Realschule/ -n	the secondary school ('R_')	die
Beute/ - kein plural oder n	the prey, booty, loot, quarry, box (for beekeeping)	die
Henkel/ -	the handle (of a cup, pitcher, etc.), handhold (not 'Griff')	der
Angelegenheit/ -en	matter, issue, affair, concern, case	die
Bankkaufmann/ -leute	the bank clerk	der
Übernahme/ -n	the takeover, acquisition	die
Eiserne Vorhang	the Iron Curtain (no plural)	der
Fahrradverleih/ -e	the bike rental	der
UV-Strahlen	the UV-rays (plural only)	die
Bedingung/ -en	the condition, requirement, term, stipulation, prerequisite ('B_')	die
Rätsel/ -	the riddle, conundrum, mystery, puzzle, enigma	das
gekochte Ei/ -er	the boiled egg	das
Reichweite	range, reach	die
stimmt.	That's right.	Das
Bermudashorts	the Bermuda shorts (no plural)	die
Rote Kreuz	the Red Cross (no plural)	das
Jobliste/ -n	the list of jobs	die
Rabatt/ -e	the discount (R_)	der
Zusammenfassung/ -en	the summary	die
Känguru/ -s	the kangaroo	das
Öffentlichkeit/ -en	the public/ the publicity	die
Softdrink/ -s	the soft drink	der
macht nichts!	That doesn't matter!	Das
Sportreportage	the sports report (no plural)	die
Asche/ -n	the ash, cinder	die
Weltmeer/ -e	the ocean ('W_')	das
Klavierlehrer/ -	the piano teacher	der
E-Mail/ -s	the email	die
kommt nicht in Frage!	That's out of the question!	Das
Geigerin/ -nen	the female violinist	die
Fachmann/ - Fachleute	specialist, expert, professional	der
Spielwaren	the toys ('Spielsachen,' 'Spielzeuge,' or ...)	die
Österreicher/ -	the Austrian person	der
Schauspieler/ -	the actor, comedian, showman (not 'D...')	der
Panzer/ -	armor, tank, shell (zool)	der
Ausschluss/ -"e	exclusion, expulsion, suspension, elimination, disqualification	der
Identität/ -en	the identity	die
Diener/ -	the attendant, servant, valet, butler	der
Gouverneur/ -	the governor	der
Automechaniker/ -	the auto mechanic	der
Teilzeitarbeit/ -en	the part time work ('Nebentätigkeit' or ...)	die
Ehemann/ -"er	the husband ('Mann,' 'Gatte,' or ...)	der
Zweitwagen/ -	the second car 'Zweitauto' or ...)	der
Altersgruppe/ -n	the age group	die
Aufenthaltsdauer	the length of stay (no plural)	die
Börsenbericht/ -e	the stock market report	der
Umbau/ -ten	the conversion, renovation, reconstruction, rebuild	der
Ähnlichkeit/ -en	the resemblance, analogy, similarity, likeness	die
Standpunkt/ -e	the standpoint, viewpoint	der
Reformhaus/ -"er	the health food store ('R_')	das
Weltfirma/ die Weltfirmen	the global company, worldwide company	die
protokoll/ -e	the minutes (of a meeting), log (computer), report, protocol	das
Rubrik/ -en	the column, category, heading, rubric, section (newspaper)	die
Wert/ -e	the worth, value, merit	der
Fahrkartenschalter/ -	the ticket office, ticket window, booking office (bus, plane, travel)	der
betrug/ -	the deceit, deception, fraud, cheating	der
Vereinigten Staaten	the United States (plural only)	die
Lehrbuch/ -"er	the textbook, schoolbook ('Fachbuch' or ...)	das
Bereich	range, area, region	der
kapitel/ -	the chapter, chapters	das
Lastkraftwagen/ -	the truck (full term/long version)	der
Abwicklung/ -en	the handling, transation, processing, execution ('A_')	die
schlag/ "e	the blow, punch, jab, beat (heart, pulse, drums, waves)	der
Rotkäppchen	the Little Red Riding Hood (no plural)	das
Auswanderung/ -en	the exodus, hemorrhage (fig), emigration ('Au_')	die
Darsteller	the actor, performer (male) (not 'S...')	der
Scheidung/ -en	the divorce	die
Flugbegleiter/ -	the male flight attendant	der
Bundesland/ -"er	the German state	das
Anordnung/ -en	the order (a command), arraangement (order of items)	die
Fahrradweg/ -e	the bicycle path	der
Präteritum	the simple past tense (no plural)	das
Einstufung/ -en	the classification, assessment, grading, rating, placement	die
Betrüger	the fraud, crook, cheater, swindler, deceiver ('B_')	der
E-Mail-Adresse/ -n	the email address	die
Violinist/ -en/ -en	the violinist ('Geiger' or ...)	der
Winterjacke/ -n	the winter jacket	die
Fachhochschule/ -n	the technical college	die
Hausärztin/ -nen	the female family doctor, general practitioner	die
Übernachtung/ -en	the overnight stay	die
Hersteller/ -	manufacturer, producer, manufacturers, maker	der
Erlebnis/ -se	the experience (not 'Erfahrung')	das
Applaus/ -e	the applause	der
Lebenshaltungskosten (Plural)	The cost of living	die
T-Shirt/ -s	the T-shirt	das
Doppelgänger	the lookalike, the double, the fetch (in movies), sb who looks like/doubles as sb else.	der
Vokabel/ -n	the vocabulary ('V_')	die
Barcode/ -s	the barcode ('not Strichcode,' 'Balkencode')	der
Fundbüro/ -s	the lost property office, lost and found office	das
Insekt/ -en	the insect	das
Übung/ -en	the exercise, practice, drill, tutorial (university) training	die
Angabe/ n	statement, declaration, specification, indication, information ('A_')	die
Schulkamerad/ -en	the classmate ('S_')	der
Königreich/ -e	kingdom, realm	das
Fahrgast/ -"e	the passenger ('F_')	der
Relikt	the remnant, relic, leftovers (not 'Überbleibsel')	das
Fahrradhelm/ -e	the bicycle helmet	der
Lexicon/ die Lexica	the encyclopedia (L-)	das
Fliege/ -n	the fly (insect)	die
Übersetzer/ -	the translator, compiler (computer)	der
Nachweis/ -e	proof, evidence, verification (not 'Beweis,' 'Beleg,')	der
Aufregung/ -en	excitement, commotion, fuss (not 'G_')	die
Gabe/ -n	the talent, gift (talent), endowment, present (not 'Talent')	die
Beleg/ -e	proof, evidence, supporting document, sales receipt	der
Katastrophe/ -n	disaster, catastrophe	die
Fußballmatch/ -es	the soccer match, football match	das
Anwendung/ -en	the application, use, implementation ('A_')	die
Gewissen	the conscience	das
Änderung/ -en	the change ('Ä_')	die
Vorfall/ -"e	the incident, event, occurrence, episode ('V_')	der
Verfassung/ -en	the constitution (law) condition, shape (state)	die
Kehle/ -n	the throat, gorge, esophagus, valley	die
Klatschzeitung/ -en	the tabloid	die
Geschirrspüler/ -n	the dishwasher ('G_')	die
Trauer	the grief, sorrow, mourning ('T_')	die
Umstand/ -"e	circumstance, case, fact	der
Fluggesellschaft/ -en	the airline	die
Legende/ -n	the legend, key	die
Flügel/ -	wing, wings	der
Akademie/ -n	the academy	die
Jahrestag/ -e	The anniversary (not 'Jubiläum')	der
verstärkung/ -en	the reinforcement, boost, strengthening, amplification	die
Erwartung/ -en	the expectation, anticipation, prospect, speculation	Die
Buchung/ -en	booking, reservation (travel), ticketing, accounting	die
Sammlung/ -en	the collection, anthology (lit), gathering of people	die
Ordner/ -	the folder, file, folders	der
Essen/ -	the meal, food	das
flieger/ -	the aviator, flyer, aircraft, plane	der
Unterlage/ -n	the document, pad (writing), pad, cushion, base (bottom support), underlayment	die
Rakete/ -n	the rocket, missile	die
Großbuchstabe/ -n	the capital letter	der
Vereinigung/ -en	the association, federation, society, union	die
Herausforderung/ -en	the challenge	die
Ärger/ -	the annoyance, anger, trouble, hassle	der
leichtigkeit/ -	the ease, easiness, lightness, light-heartedness	die
heiliger/ -	the male saint	der
Bestandteil/ -e	the component, ingredient, constituent, feature, element	der
Besprechung/ -en	the meeting, review, conference, talk ('B_')	die
Haftung/ -en	the liability, responsibility, accountability, adhesion (tech)	die
Missbrauch/ -"e	the abuse, misuse, malpractice	der
kenntnis/ -se	the knowing, knowledge, acquaintance, congnizance	die
Vermieter/ -	the landlord	der
Bearbeitung/ -en	the processing, treatment, handling, editing, process ('not 'Behandlung')	die
Siedlung/ -en	the settlement, colony	die
Klärung/ -en	the clarification ('not 'Erklärung')	die
Umwandlung/ -en	the conversion, converting, transformation	die
Asyl/ -e	the asylum, refuge, shelter	das
Anbau/ -	cultivation, crop growing	der
Droge/ -n	the drug	die
enigen	those (for all 'those' who ...)	die
Schwarzwälder Kirschtorte	the Black Forest cake	die
Anbau/ -ten	addition, attachment, annex (building)	der
Betrachtung/ -en	the consideration, contemplation, reflection, observation (not 'überlegung')	die
herkunft/ -"e	the origin, derivation, descent, source, anscestry	die
Überraschung/ -en	the suprise, astonishment	die
Studiengang/ -"e	the major (in college), course of study (not 'Hauptfach')	der
Existenz/ -en	the existence (not 'S...')	die
Zauber/ -	the magic, spell, enchantment (not 'Magie,' 'Zauberei')	der
Deal/ -s	deal, bargain	der
Seil/ -e	the rope, cable	das
Forderung/ -en	the claim (legal), demand (for goods, better treatment), call (for peace, calm) ('F_')	die
Laufzeit/ -en	the duration, term (life of a loan), time period, runtime	die
Maßnahme/ -n	the measure (step taken to handle an issue)	die
Entdeckung/ -en	the discovery, detection, spotting	die
Faden	the thread, yarn, string	der
Richtlinie/ -n	the guideline, policy, directive	die
Geduld/ -	the patience, forbearance	die
Gehalt/ -e	the content, contents, substance (of sth) (not 'Inhalt')	der
Postfach/ -"er	mailbox (comp), P.O. Box	das
Ordnung/ -en	the order (orderliness, tidiness)	die
Rücksicht/ -en	the consideration, regard, deference, thoughtfulness, concern ('R_')	die
Versehen/ -	mistake, oversight (not 'F...')	der
Einstieg/ -e	the entry, access point, gateway, entrance (not 'Eingang')	der
Stabilität	the stability, resilience, solidity	die
Übersetzung/ -en	the translation	die
Kanzlerin/ -nen	the female chancellor	die
Großteil/ -	the bulk, majority, greatest portion ('G_')	das
Bedarf/ -e	the need, requirement (not 'A_,' 'N_')	der
Aktie/ -n	the share/ the stock (finance)	die
Fingerabdruck/ -"e	the fingerprint	der
Zuständigkeit/ -en	the responsibility, jurisdiction ('Z_')	die
Unterfangen/ -	the effort, endeavor, venture ('U_')	das
Ausstattung/ -en	equipment, furnishings	die
Anspruch/ -"e	the claim (legal), entitlement, demand ('A_')	der
einnahme/ -n	the income, revenue, ingestion	die
Hausarbeit/ -	the house work, home work	die
Rückzug/ -"e	the retreat, withdrawal, pullback, pullout	der
Zugriff/ -e	the access, grasp, grip, hit (on a webpage)	der
Nachdruck/ -e	the emphasis, stress, reprint (print) ('N_')	der
Bürokaufmann/ -leute	the male office clerk ('B_')	der
Angestellter	the (male) employee, clerical worker, white collar worker ('An_')	der
Kunstwerk/ -e	the work of art, artwork	das
Gesetzgeber/ -	the lawmaker, legislator	der
Moderator/ -en	the presenter, host, moderator	der
Beschluss/ "-e	resolution, decision, ruling	der
Todesstrafe/ n	the death penalty, capital punishment	die
Genehmigung/ -en	the approval, permit, authorization, permission, consent	die
Freiheitsstrafe/ n	the imprisonment, prison sentence	die
Stellvertreter/ -	the deputy (politics), proxy, representative, delegate	der
Schlafmöglichkeit/ -en	the sleeping facility	die
Schrecken/ -	the horror, the terror, the shock	die
Zusammensetzung/ -en	the composition, structure, compound (chem), formulation	die
Aufklärung	the Enlightenment, information, clarification	die
heißt (d.h.)	that is (i.e.), that is to say, which is to say, that means	das
Berater/ -	the consultant, counselor, adviser	der
Ärmel/ -	the sleeve	der
Freigabe/ -n	the release, approval, clearance (control authorization)	die
Alarm/ -e	the alarm, alert (not 'Wecker')	der
Sein/ -	the being, existence (not 'Existenz')	das